爱情	(romantic) love
安排	arrange; to plan
安全	safe; safety; secure; security
按时	on time; on schedule
按照	according to; in accordance with; in light of
百分之	percent
棒	stick; club; good; excellent
包子	steamed stuffed bun
保护	to protect; to defend
保证	to guarantee; ensure
报名	sign up; apply
抱	to hold; to hug; carry in one's arms; to cradle
抱歉	be sorry; feel apologetic; to regret
倍	(two, three, etc)-fold; times (multiplier)
本来	originally; at first
笨	stupid; foolish; silly; dumb; clumsy
比如	for example; for instance; such as
毕业	to graduate; to finish school
遍	a time; everywhere; turn; (mw for times or turns)
标准	(an official) standard; norm; criterion
表格	form (document)
表示	express; show; indicate
表演	perform; to play
表扬	to praise; commend
饼干	biscuit; cracker; cookie
并且	and; besides; moreover
博士	doctor; PhD
不得不	have to; have no choice but to; cannot but
不管	no matter (what, how, etc.); regardless of
不过	only; merely; but; however
不仅	not only; not just
部分	part; share; section
擦	to wipe; to rub; to polish
猜	to guess
材料	material
参观	to visit (a place, such as a tourist spot); inspect
餐厅	dining hall; cafeteria; restaurant
厕所	bathroom; toilet; lavatory
差不多	almost; about the same
长城	the Great Wall
长江	the Yangtze River; the Changjiang River
尝	to taste; flavor; (past tense marker)
场	courtyard; place; field; (mw for games, performances, etc.)
超过	surpass; exceed; outstrip
成功	success; to succeed
成为	become; turn into
诚实	honest; honorable
乘坐	ride; get into (a vehicle)
吃惊	be startled; be shocked; be amazed
重新	again; anew; once more
抽烟	to smoke (a cigarette, pipe, etc.)
出差	go on a business trip
出发	start out; set off
出生	be born
出现	appear; arise; emerge
厨房	kitchen
传真	fax; facsimile
窗户	window
词语	words and expressions; term; terms;
从来	always; at all times
粗心	careless; inadvertent; negligent
存	exist; to deposit; to store
错误	error; mistake; mistaken
答案	answer; solution
打扮	dress up; put on make up
打扰	disturb
打印	to print
打招呼	notify; greet; inform
打折	sell at a discount
打针	inject; get a shot; have an injection
大概	probably; roughly; approximate
大使馆	embassy
大约	approximately; about
大夫	doctor; physician
戴	put on; to wear; to respect
当	should; act as; work as; manage; match; (sound of bells)
当时	then; at that time; while
刀	knife; blade
导游	tour guide
到处	everywhere; in all places; all over
到底	after all; in the end (used in a question)
倒	to collapse; to fall; fail; to exchange; to pour; contrary to expectations
道歉	apologize; make an apology
得意	proud of oneself; complacent
得	(complement particle)
登机牌	boarding pass
等	to wait; rank; equal; etc.
低	low; to lower (one's head); droop
底	bottom; background; base
地点	place; site; location
地球	the Earth; planet
地址	address
调查	investigate; survey; inquiry
掉	to drop; to fall
丢	lose (something); throw; put aside
动作	movement; motion; action
堵车	traffic jam
肚子	belly; abdomen; stomach
短信	text message; SMS
对话	dialogue; conversation; dialog
对面	opposite; across from; the other side
对于	regarding; as far as sth. is concerned; with regards to; for
儿童	child; children
而	and; but; yet; while
发生	happen; occur; take place
发展	develop; development; growth
法律	law; statute
翻译	translate; translation; interpret
烦恼	worried; vexed
反对	oppose; fight against
方法	method; way; means
方面	aspect; field; side
方向	direction; orientation
房东	landlord
放弃	abandon; renounce; give up
放暑假	have summer vacation
放松	relax; loosen; slacken
份	part; portion; (mw for documents, papers, jobs, etc.)
丰富	rich; enrich; abundant; plentiful
否则	if not; otherwise; or else
符合	in keeping with; in accordance with; conform
父亲	father
付款	to pay
负责	responsible for (something); in charge of
复印	photocopy; duplicate
复杂	complicated; complex
富	wealthy
改变	to change; alter; to transform
干杯	to drink a toast; cheers!; bottoms up!
赶	catch up; overtake; drive away
敢	to dare
感动	be moved; to touch emotionally
感觉	to feel; become aware of; feeling
感情	feeling; emotion; sensation
感谢	thank; be grateful
干	to concern; shield; dry; clean
刚	just (indicating the immediate past); recently; firm
高速公路	highway
胳膊	arm
各	each; every
工资	wages; pay; earnings; salary
公里	kilometer
功夫	kung fu; skill; art; labor
共同	together; common; joint
购物	go shopping; buy goods
够	enough; to reach
估计	appraise; estimate
鼓励	encourage; inspire
故意	deliberately; intentional; on purpose
顾客	customer; client
挂	hang; put up; suspend
关键	crucial; key; pivotal
观众	spectator; audience
管理	supervise; manage
光	light; ray; bright; only; merely; used up
广播	broadcast; on the air
广告	advertisement; a commercial
逛	to stroll; to visit; go window shopping
规定	regulation; stipulate; fix; set
国籍	nationality
国际	international
果汁	fruit juice
过程	course of events; process
海洋	ocean
害羞	blush; shy
寒假	winter vacation
汗	sweat; perspiration; Khan
航班	scheduled flight; flight number
好处	benefit; advantage
好像	as if; seem to be
号码	number
合格	qualified; up to standard
合适	suitable; proper; appropriate
盒子	box
后悔	to regret; repent
厚	thick (for flat things); generous
互联网	Internet
互相	mutually; with each other
护士	nurse
怀疑	doubt; to suspect; be skeptical
回忆	to recall; recollect
活动	activity; exercise; move about
活泼	lively; vivacious
火	fire
获得	obtain; acquire; to gain
积极	active; positive; energetic
积累	accumulate; accumulation
基础	base; foundation
激动	excite; agitate
及时	timely; in time; promptly; without delay
即使	even if; even though
计划	plan; project
记者	reporter; journalist
技术	technology; technique; skill
既然	since; given that; now that
继续	to continue; to go on; to proceed
寄	send by mail
加班	work overtime
加油站	gas station
家具	furniture
假	fake; if; borrow; vacation; holiday
价格	price
坚持	persist in; persevere
减肥	go on a diet; lose weight
减少	reduce; to decrease
建议	to propose; to suggest; recommend
将来	the future
奖金	bonus
降低	reduce; to lower; to drop
降落	descend; to land; put down
交	deliver; turn over; intersect; to pay (money); friendship
交流	communicate; exchange; give and take; interaction; to alternate
交通	traffic; transportation
郊区	suburbs; outskirts
骄傲	proud; arrogant; conceited; take pride in
饺子	dumpling; potsticker
教授	professor; instruct; to lecture
教育	education
接受	accept; receive (honors, etc.)
接着	continue; carry on; to catch; follow
节	section; part; festival; moral integrity; save; (mw for class periods)
节约	frugal; to save
结果	result; outcome; finally
解释	to explain
尽管	despite; although; even though; freely; without hesitation
紧张	nervous; tension; strain
进行	carry on; carry out; undertake
禁止	to ban; prohibit
京剧	Beijing Opera
经济	economy; economic
经历	undergo; to experience
经验	experience
精彩	brilliant; spectacular; wonderful
景色	scenery; landscape; scene; view
警察	police
竞争	compete
竟然	unexpectedly; to one's surprise; go so far as to
镜子	mirror
究竟	after all; when all is said and done; actually
举	lift; raise; cite
举办	to conduct; to hold
举行	convene; to hold (a meeting, ceremony, etc.)
拒绝	to refuse; to decline; to reject
距离	distance; be apart; away from
聚会	hold a meeting; get together; a party
开玩笑	joke; play a joke; make fun of
开心	feel happy; have a great time; make fun of somebody
看法	point of view; opinion
考虑	think over; consider
烤鸭	roast duck
科学	science; scientific knowledge
棵	(mw for plants)
咳嗽	to cough
可怜	pitiful; poor; pathetic
可是	but; however
可惜	it's a pity; regrettable; too bad
客厅	living room; parlor
肯定	sure; definite; affirm; approve
空	empty; sky; leave blank; leisure
空气	air
恐怕	be afraid; to fear; I'm afraid that...
苦	bitter; miserable
矿泉水	mineral water
困	sleepy; surround; hard-pressed
困难	difficulty; difficult; problem
垃圾桶	garbage can
拉	to pull; to play (string instruments); to drag
辣	hot (spicy)
来不及	there's not enough time (to do something); it's too late
来得及	there's still time
来自	come from (a place)
懒	lazy
浪费	to waste; squander
浪漫	romantic
老虎	tiger
冷静	calm; cool-headed; sober
礼拜天	Sunday
礼貌	courtesy; politeness; manners
理发	a barber, hairdressing; haircut
理解	comprehend; understand
理想	ideal
力气	physical strength; effort
厉害	terrible; formidable; fierce; cool; awesome
例如	for example; for instance
俩	(colloquial) two (people)
连	even; including; join
联系	integrate; link; connection; contact
凉快	nice and cool; pleasantly cool
零钱	small change (of money)
另外	another; in addition; besides
留	to leave (behind, a message); to retain; to stay
流利	fluent
流行	spread; prevalent; be popular
旅行	travel
律师	lawyer
乱	disorder; confusion; arbitrarily
麻烦	trouble (someone); troubling; bothersome
马虎	careless; sloppy; casual
满	full; abbreviation for Manchurian
毛	hair; fur; feather; dime
毛巾	towel; washcloth
美丽	beautiful
梦	to dream
迷路	to get lost
密码	password; secret code
免费	free (of charge); no cost
秒	second (unit of time or angle)
民族	nationality; ethnic group
母亲	mother
目的	purpose; aim; goal
耐心	to be patient
难道	could it be that ...?; don't tell me ...
难受	feel unwell; to suffer pain
内	inside; inner; internal; within
内容	content; substance; details
能力	capability; capable; ability
年龄	(a person's) age
弄	do; manage; to handle; make
暖和	warm; nice and warm
偶尔	occasionally; once in a while; sometimes
排队	queue; stand in line
排列	arrange; align; permutation
判断	to judge; judgment; to decide
陪	accompany; keep company
批评	criticize
皮肤	skin
脾气	temperament; disposition; temper
篇	sheet; (mw for articles); piece of writing
骗	to cheat; to swindle; deceive
乒乓球	ping pong; table tennis
平时	ordinarily; in normal times; in peacetime
破	broken; damaged; to split
葡萄	grape
普遍	common; universal; general; widespread
普通话	Mandarin (common language)
其次	next; secondly
其中	among; in; included among these
气候	climate; atmosphere; weather
千万	ten million; be sure to; must
签证	visa
敲	knock; blackmail
桥	bridge
巧克力	chocolate
亲戚	a relative (i.e. family relation)
轻	light; easy; gentle; soft
轻松	relaxed; gentle; easygoing
情况	circumstance; state of affairs; situation
穷	poor; exhausted
区别	difference; distinguish
取	to take; get; choose
全部	whole; entire; complete
缺点	weak point; defect; fault; shortcoming
缺少	to lack; be short of; be deficient in
却	but; yet; however
确实	indeed; in truth; reliable
然而	however; yet; but
热闹	bustling; lively; busy
任何	any; whatever; whichever
任务	a mission; an assignment; a task
扔	to throw; throw away
仍然	still; yet
日记	diary
入口	entrance
散步	to go for a walk
森林	forest
沙发	sofa
伤心	sad; grieve; brokenhearted
商量	consult; talk over; discuss
稍微	a little bit; slightly
勺子	spoon; scoop; ladle
社会	society
申请	apply for; application
深	deep; profound; dark (of colors)
甚至	even (to the point of); so much so that
生活	life; livelihood; to live
生命	life
生意	business; trade
省	to save; economize; omit; province
剩	have as remainder; be left over; surplus
失败	be defeated; fail; lose
失望	disappointed; lose hope
师傅	master; qualified worker; teacher
十分	very; fully; 100%
实际	actual; reality; practice
实在	honest; in reality; honestly; indeed; certainly
使	to use; to make; to cause; enable; envoy; messenger
使用	to use; employ; apply; administer; manipulate
世纪	century
是否	whether (or not); if
适合	to suit; to fit
适应	to suit; to fit; adapt
收	receive; accept; collect; to harvest
收入	take in; income; revenue
收拾	to tidy; put in order; to repair; to settle with; punish
首都	capital (city)
首先	first (of all); in the first place; firstly
受不了	cannot endure; unbearable; can't stand
受到	receive (influence, restriction, etc.); be subjected to
售货员	salesclerk; shop assistant; salesperson
输	to transport; to lose (a game, etc.)
熟悉	familiar with; know well
数量	amount; quantity; number
数字	number; numeral; figure; digit
帅	handsome; graceful; commander-in-chief
顺便	conveniently; in passing; on the way
顺利	go smoothly; without a hitch; successful
顺序	sequence; order
说明	explain; explanation; illustrate; to show
硕士	Master's degree (M.A.)
死	to die; dead; fixed; impassible; extremely
速度	speed; rate; velocity
塑料袋	plastic bag
酸	sour; sore; ache
随便	as one pleases; informal; random; casual
随着	along with; in the wake of
孙子	grandson; son's son
所有	all; to have; to possess
台	platform; desk; stage; (mw for machines)
抬	to lift; to raise (with both palms up); carry (together)
态度	manner; bearing; attitude
谈	to talk; to chat; discuss
弹钢琴	play the piano
汤	soup; broth
糖	sugar; candy; sweets
躺	recline; lie down (on back or side)
趟	(mw for trips times); to wade
讨论	to discuss; discussion; to talk over
讨厌	to hate; loathe; disgusting; troublesome
特点	a characteristic; trait; feature
提	to carry; to lift; to raise (an issue)
提供	to supply; provide; furnish
提前	shift to an earlier date; bring forward; to advance
提醒	remind; call attention to; warn of
填空	fill in the blanks; fill a vacancy
条件	condition; circumstances; prerequisite
停	to stop; to halt; to park (a car)
挺	straighten up; stick out; rather (good); very
通过	by means of; through (a method); pass through; via
通知	notify; to inform; notice
同情	compassion; sympathy
同时	at the same time; simultaneously
推	to push; to scrape; to decline; postpone; elect
推迟	postpone; defer
脱	to shed; take off; to escape
袜子	socks; stockings
完全	complete; whole; totally
网球	tennis; tennis ball
网站	website
往往	often; frequently; more often than not
危险	danger; dangerous; perilous
卫生间	restroom; bathroom; water closet (WC)
味道	flavor; taste
温度	temperature
文章	article; essay
污染	pollution; contamination
无	have not; without; not
无聊	nonsense; bored; silly; stupid
无论	no matter what; regardless of whether...
误会	to misunderstand; to mistake
西红柿	tomato
吸引	attract (interest, investment, etc.)
咸	salty; salted
现金	cash
羡慕	to envy; admire
相反	opposite; contrary
相同	identical; same; alike
香	fragrant; savory
详细	detailed; in detail; minute
响	make a sound; to ring; echo
橡皮	rubber; an eraser
消息	news; information
小吃	snack; refreshments
小伙子	young man; lad; youngster
小说	novel; fiction
笑话	joke; laugh at
效果	effect; result
心情	mood; state of mind
辛苦	hard; exhausting; toilsome; laborious
信封	envelope
信息	information; news; message
信心	confidence; faith (in sb. or sth.)
兴奋	excitement； be excited
行	walk; be current; do; will do; okay
醒	wake up
幸福	happy; blessed; fortunate
性别	gender; sex; sexual distinction
性格	nature; personality; temperament
修理	to repair; perform maintenance; to overhaul
许多	many; a lot; much
学期	semester; school term
压力	pressure; stress
呀	ah; oh; (used for 啊 after words ending with a, e, i, o, or ü)
牙膏	toothpaste
亚洲	Asia
严格	strict; stringent; tight
严重	grave; serious; critical
研究	to study; to research
盐	salt
眼镜	glasses; spectacles
演出	to act (in a play); to perform; to put on a show; performance
演员	actor or actress; performer
阳光	sunshine; sunlight
养成	cultivate; acquire; to form
样子	manner; air; appearance; looks
邀请	to invite
要是	if; suppose; in case
钥匙	key
也许	perhaps; probably; maybe
叶子	leaves; foliage; leaf
页	page; leaf
一切	all; every; everything
以	to use; according to; so as to; for; by
以为	think (mistakenly); consider (that); believe
艺术	art
意见	opinion; view; suggestion; complaint
因此	therefore; thus; that is why; because of this
引起	give rise to; lead to; to cause; arouse
印象	impression
赢	to win; to beat; to profit
应聘	accept a job offer; to apply for a job
永远	forever; eternal; always
勇敢	brave; courageous
优点	merit; good point; a strength; a benefit
优秀	outstanding; excellent
幽默	humorous
尤其	especially; particularly
由	follow; from; by; through
由于	due to; owing to; as a result of; thanks to
邮局	post office
友好	friendly (relations); close friends
友谊	friendship; companionship
有趣	interesting; fascinating; amusing
于是	as a result; thus; therefore
愉快	happy; cheerful; delightful
与	(formal) and; to give; together with; participate; final particle expressing doubt or surprise
羽毛球	badminton
语法	grammar
语言	language
预习	(of students) prepare a lesson before class; preview
原来	original; former; as it turns out
原谅	to excuse; forgive; to pardon
原因	cause; reason
约会	appointment; engagement; date
阅读	read; reading
云	cloud
允许	to permit; allow
杂志	magazine
咱们	we (including the listener); us; our
暂时	temporary; transient; for the moment
脏	filthy; dirty
责任	responsibility; blame; duty
增加	to increase; to raise; add
占线	the (phone) line is busy
招聘	recruitment; take job applications for a job
照	to shine; illuminate; according to
真正	genuine; real; true
整理	put in order; arrange; straighten up; to tidy; to pack (luggage)
正常	normal; regular; ordinary
正好	just (in time); just right; just enough; happen to; by chance
正确	correct; proper
正式	formal; official
证明	proof; testify; confirm; certificate
之	(literary equivalent to 的); (pronoun); of
支持	sustain; hold out;; support; stand by (e.g. international support)
知识	knowledge; intellectual
直接	direct; immediate
值得	be worth; deserve
职业	profession; occupation
植物	plant; botanical; vegetation
只好	have to; be forced to
只要	so long as; if only; provided that
指	finger; to point (at, to, out); refer to
至少	at least; (to say the) least
质量	quality; mass (physics)
重	heavy; serious; important
重点	emphasis; main point
重视	to value; take seriously
周围	surroundings; vicinity; environment
主意	plan; idea; decision
祝贺	congratulate
著名	famous; well-known; celebration
专门	specialized
专业	profession; specialized field of study; major
转	to turn; to change; pass on; revolve; rotate
赚	earn; make a profit
准确	accurate; precise
准时	punctually; on time
仔细	careful; attentive; cautious
自然	nature; natural
自信	self-confidence
总结	summarize; conclude
租	to rent
最好	the best; had better ...; it would be best
尊重	esteem; to respect; to value; to honor
左右	about; approximate; around; left and right
作家	author; writer
作用	action; activity; effect
作者	author; writer
座	(mw for mountains, bridges, tall buildings, etc.);; seat; base; stand; constellation
座位	seat; place