挨	get close to; in sequence
癌症	cancer
爱不释手	love something too much to part with it
爱戴	love and respect
暧昧	ambiguous; shady
安宁	peaceful; calm; tranquil; composed
安详	serene; composed
安置	find a place for; help settle down; arrange for
按摩	massage
案件	legal case; judicial case
案例	(Law) case
暗示	drop a hint; suggest
昂贵	expensive; costly
凹凸	(of a surface) uneven; bumpy
熬	endure; to boil
奥秘	mystery; enigma; profound; deep
巴不得	eagerly look forward to; earnestly wish; be only too anxious to
巴结	to fawn on; curry favor with
扒	dig up; pull down; take off
疤	scar
拔苗助长	(literally) help shoots grow by pulling them out; spoil things by excessive enthusiasm
把关	guard a pass; check on
把手	knob; handle; grip
罢工	to strike; go on strike
霸道	overbearing; despotic hegemony; rule by force; (of liquor, medicine, etc.) strong
掰	break with both hands
摆脱	break away; free oneself from; cast off
败坏	ruin; corrupt; undermine
拜访	pay a visit; call on
拜年	congratulate the New Year; wish sb. a Happy New Year
拜托	ask a favor; request; please!
颁布	promulgate; to issue; publish (e.g a decree)
颁发	issue; promulgate; award
斑	variety; speckled; spot; colored patch; stripe
版本	edition
半途而废	give up halfway; leave sth. unfinished
扮演	play the part of; act
伴侣	companion; partner; mate
伴随	accompany; go with; follow
绑架	kidnap; staking
榜样	example; model
磅	pound; weigh; scale
包庇	to shield; to harbor; cover up
包袱	bundle wrapped in cloth; cloth-wrapper
包围	surround; encircle; hem in
包装	to pack; package; make up
饱和	saturation
饱经沧桑	experienced many changes
保管	assure; take care of; surely
保密	keep secret/confidential
保姆	nanny; housekeeper
保守	conservative (ideas, estimates, politically, etc.); to guard; to keep
保卫	defend; to safeguard
保养	take good care of (or conserve) one's health; keep in good repair
保障	ensure; to guarantee; protect
保重	take care (of oneself)
报仇	retaliate; to revenge; avenge
报酬	reward; remuneration
报答	repay; requite
报复	retaliate; revenge
报警	report (an incident) to the police
报销	submit an expense account; apply for reimbursement; write off
抱负	aspiration; ambition
暴力	violence; (use) force
暴露	expose; reveal; lay bare
曝光	to expose; to make public
爆发	break out; erupt; explode
爆炸	explode; explosion; blow up
卑鄙	base; mean; despicable; contemptible; unprincipled
悲哀	grieved; sorrowful; sad
悲惨	miserable; tragic
北极	the North Pole
贝壳	shell; conch; cowry
备份	to back up; a backup
备忘录	memorandum; aide-memoire; diplomacy memorandum; memorandum book
背叛	betray; forsake
背诵	recite
被动	passive
被告	defendant
奔波	rush about; be busy running about
奔驰	run quickly; speed; Mercedes-Benz (German vehicle manufacturer)
本能	instinct
本钱	capital (financial)
本人	I; me; myself; oneself; in person
本身	itself; in itself; per se
本事	ability; skill; capability; (-shì: this matter; literary source)
笨拙	clumsy; awkward; stupid
崩溃	collapse; crumble; fall apart
甭	need not; (contraction of 不 and 用)
迸发	burst forth; burst out
蹦	jump; bounce; hop
逼迫	to force; compel; coerce
鼻涕	nasal mucus; snivel
比方	instance; analogy; example
比喻	metaphor; analogy; figure of speech
比重	proportion; specific gravity
鄙视	despise; disdain; look down upon
闭塞	stop up; shelter from; hard to get to; unenlightened
弊病	malady; evil; malpractice; drawback
弊端	malpractice; abuse; corrupt practice
臂	arm
边疆	border area; borderland; frontier; frontier region
边界	boundary; border
边境	frontier
边缘	edge; fringe; verge; brink
编织	to weave; to knit; to plait; to braid; to crochet
鞭策	spur on; urge on
贬低	to belittle; depreciate; disparage
贬义	negative connotation; derogatory sense
扁	flat
变故	unforeseen event; accident
变迁	changes; vicissitude
变质	go bad; deteriorate; metamorphism
便利	convenient; easy; facilitate
便条	informal note
便于	be easy; be convenient for
遍布	to cover the whole (area); found everywhere; spread all over
辨认	distinguish; identify; recognize
辩护	speak in defense of; argue in favor of; defend
辩解	explain; justify; defend (a point of view, etc.)
辩证	investigate; dialectical
辫子	plait; braid; pigtail
标本	specimen; sample; the root cause and symptoms of a disease
标记	sign; mark; symbol
标题	title; header; headline; caption
表决	decide by vote; vote
表态	make known one's position; declare where one stands
表彰	cite (in dispatches); commend
憋	hold in (urine); hold (breath); choke
别墅	villa
别致	unique; unconventional; fancy
别扭	awkward; unnatural
濒临	on the verge of
冰雹	hail
丙	bright; fire (3rd Heavenly Stem)
并非	really isn't
并列	stand side by side; be juxtaposed
拨	to dial; move with a hand/foot; stir; poke; allocate (money)
波浪	wave
波涛	great waves; billows
剥削	to exploit
播种	sow seeds; sowing; seed
伯母	aunt; wife of father's older brother
博大精深	broad and profound
博览会	(international) exhibition
搏斗	fight; struggle; wrestle
薄弱	weak; frail
补偿	compensation; make up
补救	remedy; repair
补贴	subsidy; allowance
捕捉	catch; to seize
哺乳	breast-feeding; to suckle
不得已	act against one's will; have no alternative
不妨	there is no harm in; might as well
不敢当	(literally) I dare not accept the honor; you flatter me
不顾	in spite of; regardless of; to disregard
不禁	cannot help; can't refrain from
不堪	cannot bear/stand; utterly
不可思议	unimaginable; inconceivable
不愧	be worthy of; deserve to be called; prove oneself to be
不料	unexpectedly; to one's surprise
不免	unavoidable
不时	frequently; often; at any time
不惜	to not hesitate; not spare
不相上下	equally matched; about the same
不像话	unreasonable; absurd; outrageous
不屑一顾	not worth seeing; disdain as beneath contempt
不言而喻	it goes without saying; it is self-evident
不由得	can't help; cannot but
不择手段	by fair means or foul
不止	incessantly; more than
布告	notice; bulletin
布局	arrangement; composition; layout
布置	arrange; decorate; decoration
步伐	pace; (measured) step; march
部署	dispose; deploy
部位	position; place
才干	ability; competence
财富	wealth; riches; fortune
财务	financial affairs
财政	public finances; financial
裁缝	tailor; dressmaker
裁判	judge; to referee; judgment
裁员	cut staff; lay off employees
采购	make purchases for an organization; go shopping
采集	gather; collect
采纳	accept; adopt
彩票	lottery; lottery ticket
参谋	advisor; give advice
参照	consult a reference; refer to (another document)
残疾	deformity; handicapped; crippled
残酷	cruel
残留	to remain; be left over; surplus; remnant
残忍	brutal; bloody; merciless
灿烂	to glitter; brilliant; splendid
仓促	hurried
仓库	depot; storehouse; warehouse
苍白	pale; wan; pallid
舱	cabin; hold (of a ship or airplane)
操劳	work hard; look after
操练	to drill; to practice
操纵	operate; control; manipulation
操作	operate; manipulate
嘈杂	noisy; raucous
草案	draft (legislation, proposal, etc.)
草率	cursory; careless; negligent; sloppy; not serious
侧面	side; profile; flank; face in profile
测量	to survey; to measure
策划	plot; scheme; bring about
策略	tactics; plot
层出不穷	(idiom) emerge more and more; innumerable succession; breeding like flies
层次	level; rank order; standing; layer
差别	difference; disparity
插座	power socket
查获	investigate and capture a criminal; discover
岔	fork in the road; turn off; diverge
刹那	an instant (Sanskrit: ksana); split second
诧异	flabbergasted; astonished
柴油	diesel fuel; kerosene
搀	assist by the arm; mix; support; sustain
馋	gluttonous; greedy
缠绕	bind; wind; twirl; twist; intertwine
产业	industry; estate; property
阐述	expound (a position); elaborate (on a topic)
颤抖	tremble; to shiver; to shake
昌盛	prosperous
尝试	to try; attempt
偿还	repay; reimburse
场合	occasion; situation
场面	scene; occasion
场所	location; place
敞开	open wide
畅通	unimpeded; unclogged; free-flowing; straight path; to expedite
畅销	best seller; chart-topping; very marketable
倡导	to advocate; propose
倡议	suggest; propose
钞票	paper money; bill
超越	surpass; exceed; transcend
巢穴	lair; nest; den; hideout
朝代	dynasty; reign (of a king)
嘲笑	jeer; mock; scoff
潮流	tide; current; trend
撤退	retreat
撤销	repeal
沉淀	to precipitate (solid sediment out of a solution); to settle
沉闷	oppressive (of weather); heavy; depressed; not happy
沉思	ponder; contemplate; meditation
沉重	heavy; hard; serious
沉着	calm and collected; not nervous
陈旧	old fashioned; outmoded; obsolete
陈列	to display; to exhibit
陈述	allegation; assertation; to declare; to state
衬托	to set off; serve as a foil to
称心如意	find sth. satisfactory
称号	title; term of address
成本	cost (manufacturing, production, etc.)
成交	complete a contract; clinch a deal; to seal
成天	all day long; all the time
成效	effect; result
成心	intentional; deliberate; with prior intent
成员	member
呈现	appear; emerge; present (a certain appearance)
诚挚	sincere; cordial; earnest
承办	undertake; accept an assignment
承包	to contract (to undertake a job)
承诺	to promise
城堡	castle
乘	to ride; to mount; make use of; multiply
盛	contain; to ladle; to fill; flourishing; grand; abundant
惩罚	penalty; punishment; to punish; to penalize
澄清	(of liquid) settle; become clear; (Chem.) precipitate
橙	orange (color); orange (fruit, tree)
秤	balance; scale; steelyard
吃苦	bear hardships; suffer
吃力	strenuous; exhausted
迟钝	slow (witted); stupid; dull
迟缓	slow; sluggish
迟疑	hesitate
持久	duration; enduring; lasting; persistent
赤道	the equator
赤字	(financial) deficit; red ink
冲动	impulsive; act on impulse
冲击	attack; impact; a shock
冲突	conflict; clash
充当	serve as; play the part of
充沛	abundant; plentiful; vigorous
充实	substantial; rich; enrich; substantiate
充足	adequate; sufficient; abundant
重叠	to overlap
崇拜	worship; adore
崇高	lofty; sublime
崇敬	revere; admire; veneration
稠密	dense; thick
筹备	make preparations; get ready for something
丑恶	ugly; repulsive; odiousness
出路	a way out; outlet
出卖	sell; betray; sell out
出身	family background; class origin
出神	be lost in thought; entranced; preoccupation; Trance (music genre)
出息	future prospects; aspiration; promise
初步	initial; preliminary; tentative
除	besides; except; remove; to divide (mathematics)
处分	punish; punishment; discipline; disposal
处境	plight; unfavorable situation
处置	to handle; take care of; punish
储备	reserves; store up
储存	stockpile; to store
储蓄	to save; to deposit
触犯	offend; violate
川流不息	(saying) flowing of an endless stream
穿越	pass through; cut across
传达	convey; transmit; communicate
传单	leaflet; flier; pamphlet
传授	impart; pass on; teach
船舶	ships; boats; watercraft
喘气	to pant; gasp for breath
串	string together; conspire; gang up; mix up; bunch
床单	bed sheet
创立	to found; establish
创新	innovate; innovation
创业	begin an undertaking; start a major task; start a company
创作	create; to produce; creative work
吹牛	to brag; (regional) to chat
吹捧	flatter sb.; extol sb.'s accomplishments
炊烟	smoke from kitchen chimneys
垂直	perpendicular; vertical
锤	hammer; weight
纯粹	purely; pure
纯洁	pure; unadulterated; cleanse
慈善	philanthropic; benevolent; charitable
慈祥	a kindly person; benevolent (often of older people)
磁带	cassette tape
雌雄	male and female; winners and losers
次品	defective or substandard products
次序	sequence; order
伺候	serve; wait upon; act as a valet
刺	thorn; to sting; to prick; pierce; stab
从容	leisurely; calm
丛	crowd together; thicket; collection
凑合	bring together; make do in a bad situation; improvise
粗鲁	crude; coarse; rough; language
窜	to flee; to escape; run away
摧残	to ruin; devastate; vandalize
脆弱	weak; fragile; flimsy; frail
搓	rub or roll between the hands or fingers; to twist
磋商	discuss seriously; consult; negotiate
挫折	setback; defeat; frustration
搭	to erect; to build; travel by (car, plane, etc.); to hang; to join
搭档	team up; cooperate; work together
搭配	pair up; arrange in pairs; to add sth. into a group; to suit
达成	to reach (an agreement); achieve
答辩	reply (to an accusation)
答复	to answer; to reply
打包	get a doggy bag (at a restaurant); pack up
打官司	go to court
打击	to strike; to hit; to attack
打架	to fight; scuffle; to come to blows
打量	take measure of; size up
打猎	hunt; to go hunting
打仗	fight; go to war; fight a battle
大不了	at the worst; if worst comes to worst; serious, alarming
大臣	chancellor
大伙	everyone
大肆	wantonly; without any constraint
大体	in general; more or less; on the whole
大意	main idea; general idea; gist
大致	more or less; roughly; approximately
歹徒	evil person who commits crimes; villain; gangster
代价	price; cost; expense
代理	acting (temporarily filling a position); agent
带领	to guide; to lead
怠慢	to slight; give somebody a cold shoulder; treat somebody in a cold manner
逮捕	to arrest; to capture
担保	guarantee; vouch for
胆怯	timid; coward
诞辰	birthday
诞生	be born; come into being
淡季	off season; slow business season
淡水	fresh water; potable water (water with low salt content)
蛋白质	protein
当场	at the scene; on the spot
当初	at that time; at the outset; originally
当代	present day; contemporary
当面	to sb.'s face; in sb.'s presence
当前	current; modern; present
当事人	persons involved or implicated; party (to an affair)
当务之急	the most pressing matter of the moment; a top priority task; urgent matter
当选	be elected
党	party; club; association
档案	file; record; archive
档次	grade; quality; class; level
导弹	guided missile; cruise missile
导航	navigation
导向	guidance; lead to; direct something towards
捣乱	cause a disturbance; look for trouble
倒闭	go bankrupt; close down
盗窃	steal; pilfer
稻谷	rice crops/paddy
得不偿失	the gains do not outweigh the losses
得力	able; competent
得天独厚	enjoy exceptional advantages; richly endowed by nature
得罪	offend; a faux pas
灯笼	lantern
登陆	to land; come ashore; sign/log in
登录	sign-in
蹬	press down with the foot; step back or into something
等候	wait; queue
等级	degree; rate
瞪	stare at; to glower
堤坝	dam; dyke
敌视	be hostile; adopt a negative attitude towards
抵达	arrive; to reach (a destination); touch down
抵抗	resist; resistance
抵制	resistance; refusal (to cooperate); boycott
地步	condition; plight; extent
地势	terrain; topography of a place
地质	geology
递增	increase step by step; steadily increase
颠簸	shake; to jolt; bump
颠倒	turn upside down; upend
典礼	celebration; ceremony
典型	typical case; model
点缀	decorate; an ornament; beautify; embellish; be the finishing touch
电源	electric power supply
垫	cushion; to pad; pay for somebody and expect to be repaid
惦记	to remember with concern; to be concerned about; to think about; to keep thinking about; to worry about
奠定	establish; to found; to settle
叼	hold sth. in the mouth
雕刻	carve; engrave; sculpt
雕塑	sculpture; a statue; a Buddhist image
吊	hang; suspend
调动	to transfer; to maneuver (troops, etc.)
跌	to fall down; to drop
丁	male adult; robust; cubes (of food); T-shaped (4th Heavenly Stem)
叮嘱	urge again and again; exhort; repeatedly warn
盯	to stare; to gaze
定期	regularly; at regular intervals
定义	definition
丢人	lose face; be disgraced
丢三落四	forgetful; scatterbrained
东道主	host for a party or conference
东张西望	look in all directions; glance around
董事长	chairman of the board
动荡	(social or political) turmoil; unrest; upheaval
动机	motive; motivation; intention
动静	sound of activity; activity
动力	power; motion; impetus; driving force
动脉	artery
动身	go on a journey; leave
动手	get to work; to touch; strike a blow
动态	development; trend; dynamic state
动员	mobilize
冻结	(loan, wage, price) freeze
栋	roof beam; (mw for buildings)
兜	pocket; bag; wrap up (in a piece of cloth); move around (in a circle); canvass (solicit); take responsibility
陡峭	steep; precipitous
斗争	to struggle; to fight for; to battle
督促	supervise and urge sb. to complete a task
毒品	drugs; narcotics; poison
独裁	dictatorship
堵塞	block; stop
赌博	to gamble
杜绝	put an end to
端	end; beginning; extremity; carry holding something from the sides
端午节	Dragon Boat Festival
端正	upright; regular; proper; correct
短促	short in time duration; fleeting; brief
断定	conclude; determine; figure out
断绝	sever; break off
堆积	pile up; accumulate
队伍	ranks; troops
对策	countermeasure for dealing with a situation
对称	symmetry
对付	to handle; deal with
对抗	withstand; resist; antagonize
对立	oppose; to counter
对联	rhyming couplet; vertical written couplet usually placed along either side of a doorway
对应	corresponding; counterpart
对照	contrast; compare
兑现	cash a check; honor a commitment
顿时	immediately; suddenly
多元化	diversify; diversification
哆嗦	tremble; to shiver; to quiver
堕落	morally degenerate; become depraved
额外	extra; added; additional
恶心	disgusting; nauseous; make somebody embarrassed (èxīn: bad/vicious habit; vice)
恶化	worsen; deteriorate
遏制	keep within limits; contain; restrain; hold back
恩怨	grievance; old rivalry; mixture of gratitude and resentment
而已	that's all; nothing more
二氧化碳	carbon dioxide; CO2
发布	issue; announce; release
发财	get rich
发呆	stare blankly; daze off
发动	to start; to launch; mobilize
发觉	discover; detect
发射	to launch; to shoot (a projectile); to fire (a rocket)
发誓	to vow; to pledge; swear
发行	publish; to issue; distribute
发炎	become inflamed from infection or injury
发扬	develop; make full use of; to carry on
发育	develop; growth
法人	legal entity (i.e., a corporation)
番	(mw for acts or deeds); foreign
凡是	every; any; all; without exception
繁华	flourishing; bustling; prosperous
繁忙	busy; bustling
繁体字	traditional Chinese character
繁殖	propagate; to breed; reproduce
反驳	retort; refute
反常	abnormal; unusual
反感	(strongly) dislike
反抗	resist; to revolt
反馈	feedback; send information back
反面	the reverse side of sth.; opposite side of a topic
反射	reflex; reflection (from a mirror, etc.)
反思	think back over something that happened; to reflect; introspection
反问	ask a rhetorical question; answer a question with a question
反之	whereas...; on the other hand ...; conversely ...
泛滥	to be in flood; to overflow (the banks); to inundate; to spread unchecked
范畴	category
贩卖	sell; peddle; (often derogatory) to traffic in
方位	position; direction; points of the compass; bearing
方言	dialect
方圆	circumference; neighborhood; vicinity
方针	policy; guidelines
防守	to defend; protect; to guard
防御	defense; resist; to guard
防止	prevent; protect; guard against; avoid
防治	prevent and cure
访问	to visit; call on; to interview
纺织	spinning and weaving; textile
放大	enlarge; amplify
放射	radiate; radioactive
飞禽走兽	birds and animals; the beasts of the field and the birds of the air
飞翔	fly; hover
飞跃	to leap
非法	illegal
肥沃	fertile
诽谤	slander; libel
肺	lung
废除	abolish; annul; abrogate
废寝忘食	to forget even sleeping and eating
废墟	ruins
沸腾	to boil; boiling
分辨	distinguish; differentiate; resolve
分寸	propriety; the limits of proper speech or action
分红	a bonus; to award a bonus; to draw or recieve dividends; to share profits
分解	to decompose; to resolve; to break down
分裂	split up; to divide; separate
分泌	secrete
分明	clear; distinct; evidently; clearly
分歧	difference (of opinion/position）
分散	to scatter; disperse; distribute
吩咐	instruct; instructions; to tell; to order (to do something)
坟墓	tomb; sepulcher
粉末	fine powder; dust
粉色	pink
粉碎	to crash; break up
分量	weight; heft; amount
愤怒	angry; indignant; furious; anger; indignation; wrath; ire
丰满	plump; well developed; plentiful; Fengman district of Jilin City, Jilin Province
丰盛	sumptuous; lavish
丰收	bumper crop; have a good harvest
风暴	storm; violent commotion
风度	elegant demeanor; grace; poise; style
风光	a natural scenic view; sight
风气	general mood; atmosphere; common practice
风趣	humor; wit; humorous
风土人情	local conditions (human and environmental)
风味	local flavor; local style
封闭	to seal; to close; confine
封建	feudal; feudalism
封锁	to blockade; to seal off
锋利	sharp (i.e. a knife blade); incisive; to the point
逢	to meet; come upon
奉献	consecrate; dedicate; devote
否决	veto; reject; overrule
夫妇	married couple; husband and wife
夫人	lady; madam; Mrs.; wife
敷衍	to elaborate (on a theme); to expound (the classics); to do sth. half-heartedly or just for show; barely enough to get by; perfunctory; apathetic; to skimp; to botch
服从	to obey; to comply
服气	be convinced
俘虏	captive; prisoner
符号	symbol; mark; sign
幅度	width; margin; extent
辐射	radiation
福利	material benefits; welfare; well-being
福气	good fortune
抚摸	gently caress and stroke; to pet; to fondle
抚养	foster; bring up; raise
俯视	look down at; overlook
辅助	assist; aide
腐败	corruption; corrupt; rotten
腐烂	rot; become gangrenous
腐蚀	erode; corrode; corrupt; rusty
腐朽	rotten; decayed; decadent; degenerate
负担	to (bear a) burden; carry; a load
附和	repeat an agreement; copy sb.'s action or words
附件	attachment; enclosure
附属	subsidiary; auxiliary; affiliate; attached
复活	resurrection
复兴	revive; restore
副	vice-; secondary; auxiliary; deputy; assistant; classifier for pairs (i.e. glasses)
赋予	confer upon; bestow; endow; entrust (a task)
富裕	rich; to prosper; wealthy
腹泻	diarrhea
覆盖	to cover
改良	improve; to reform
钙	calcium
盖章	affix one's seal; seal; stamp
干旱	drought; dry
干扰	interfere; obstruction
干涉	interfere; intervene; meddle
干预	meddle; intervene; intervention
尴尬	awkward; embarrassed
感慨	lament; with a tinge of emotion or regret
感染	infection; infect; influence
干劲	enthusiasm; energy; drive
纲领	program; guiding principle
岗位	a post; a job
港口	port; harbor
港湾	harbor; estuary
杠杆	lever; pry bar; crowbar; financial leverage
高超	excellent; superb
高潮	high tide; upsurge; climax; chorus (of a song)
高峰	peak; summit; apex
高明	brilliant; wise
高尚	nobly; lofty
高涨	upsurge; (tensions, etc.) run high
稿件	rough draft of a document
告辞	take leave; bid farewell
告诫	warn; admonish
疙瘩	swelling or lump on skin
鸽子	dove; pigeon
搁	to place; put aside
割	to cut (apart/off)
歌颂	sing the praise of; extol; eulogize
革命	revolution; revolutionary (politics); cause great social change; rise in revolt; take part in revolution
格局	structure; pattern
格式	form; specification; format
隔阂	estrangement; misunderstanding
隔离	insulate; separate; isolate
个体	individual
各抒己见	everyone gives their own view
根深蒂固	deep-rooted; ingrained; inveterate (problem, etc.)
根源	origin; root; source
跟前	in front of
跟随	follow; followed
跟踪	follow somebody's tracks; tail; shadow
更新	to replace the old with new; to renew; to renovate; to upgrade; to update; to regenerate; to rejuvenate
更正	correct; correction
耕地	arable land; to plow land
工艺品	handicraft; handiwork
公安局	public security bureau
公道	fair; equitable
公告	post; announcement
公关	public relations
公民	citizen
公然	(do something) openly; undisguised
公认	publicly know (to be); recognize; generally acknowledged
公式	formula
公务	public affairs; official business
公正	just; fair
公证	notarization
功劳	contribution; meritorious; credit
功效	efficiency; effectiveness
攻击	to attack; accuse; to charge
攻克	to capture; to take
供不应求	(saying) demand outstrips supply
供给	to furnish; provide; to supply
宫殿	palace
恭敬	dutiful; deferential
巩固	consolidate; solidify
共和国	republic
共计	sum up; total
共鸣	physical resonance; sympathetic response to something
勾结	collude with; collaborate; gang up
钩子	hook
构思	outline a story; make preliminary sketch
孤独	lonely; solitary
孤立	isolate; isolated
姑且	temporarily; the time being
辜负	let down; disappoint; fail to live up to
古董	antique
古怪	eccentric; grotesque; oddly
股东	stockholder; shareholder
股份	a share (in a company) stock
骨干	backbone; mainstay
鼓动	agitate; instigate
固然	admittedly; it is true that; indeed
固体	solid
固有	intrinsic/inherent to something; native
固执	persistent; stubborn
故乡	hometown; homeland; birthplace
故障	malfunction; breakdown
顾虑	misgivings; apprehensions
顾问	adviser; consultant
雇佣	employ; hire
拐杖	crutch; walking stick
关怀	care; solicitude; show care for; concerned about; attentive to
关照	concern; look after; keep an eye on
观光	sight see; tour
官方	official; (by the) government
管辖	administer; have jurisdiction (over)
贯彻	to implement; put into practice; carry out
惯例	conventional
灌溉	irrigate
罐	can; jar; pot; pitcher; jug
光彩	splendor; radiance; brilliance; honor
光辉	radiance; brilliant; glory
光芒	rays of light; brilliant rays; radiance
光荣	glory; honor
广阔	wide; vast
归根到底	(saying) to sum it up ...
归还	return something; revert
规范	standard (design or model); norm; without variation; to specify
规格	standard; norm; specification
规划	plan; program; project
规章	regulations; rule
轨道	orbit; railway; trajectory
贵族	lord; nobility; nobleman; noblewoman
跪	kneel
棍棒	club
国防	national defense
国务院	State Council (PRC); State Department (USA)
果断	firm; decisive
过度	excessive; exceeding; lavishly
过渡	to cross a river by ferry; transition; interim
过奖	praise excessively; flatter
过滤	to filter; filter
过失	defect; fault
过问	take an interest in; get involved with
过瘾	satisfy a craving; get a kick out of sth; do to one's heart's content
过于	too much; excessively
嗨	hey/hi (loanword); oh; alas;
海拔	height above sea level; elevation
海滨	shore; seaside
含糊	unclear; vague; unsure
含义	implied meaning; connotation
寒暄	exchanging conventional greetings; winter and summer
罕见	rare; rarely seen; peculiar
捍卫	defend; uphold; safeguard
行列	procession; ranks; queue
航空	aviation
航天	space flight
航行	to sail; to fly
毫米	millimeter
毫无	not at all; completely without; not in the least
豪迈	bold and generous; heroic
号召	call upon; summon; to appeal
耗费	waste; spend; consume
呵	breathe out; scold
合并	merge; annex
合成	compound; synthesis; mixture
合伙	to make a partnership
合算	worthwhile; reckon up
和蔼	kindly; good-tempered; amiable
和解	settlement; to become reconciled
和睦	peaceful relations; harmonious
和气	friendly; polite; amiable
和谐	harmonious; concordant
嘿	hey; interjection for calling attention
痕迹	vestige; trace
狠心	callous; cruel; cold-blooded
恨不得	cannot bear not; be dying to
横	horizontal; across; (horizontal character stroke)
哼	groan; snort; to hum; croon
轰动	a sensation; a stir
烘	to dry or warm by the fire; to bake; to heat by fire; to set off by contrast
宏观	macro-; macroscopic
宏伟	grand; imposing; magnificent; grand
洪水	flood
哄	fool; coax; to amuse (a child)
喉咙	throat; larynx
吼	roar; howl
后代	posterity; later generations; descendants
后顾之忧	fears of trouble in the rear (idiom); family worries (obstructing freedom to act); trouble back at home; worries about the future consequences; often in negative expressions, meaning no worries about anything
后勤	logistics
候选	candidate
呼唤	call out (a name etc.); shout
呼啸	whistle; scream; howl
呼吁	call on (someone to do something); appeal
忽略	ignore; forget about; neglect
胡乱	carelessly; recklessly
胡须	beard; moustache; whiskers
湖泊	lake
花瓣	petal
花蕾	(flower) bud
华丽	gorgeous; magnificent
华侨	overseas Chinese
化肥	chemical fertilizer
化石	fossil
化验	laboratory test; chemically examine
化妆	put on make-up
划分	divide up; differentiate
画蛇添足	draw legs on a snake (idiom); to ruin something by adding something superfluous
话筒	microphone; transmitter; megaphone
欢乐	gaiety; glee; delighted
还原	restore to the original state; (Chemistry) reduce
环节	link; sector; segment (of annelid worms)
缓和	alleviate; to moderate; to ease (tension)
患者	sufferer; patient; the sick
荒凉	desolate
荒谬	ridiculous; nonsensical
荒唐	beyond belief; preposterous; absurd; intemperate
皇帝	emperor
皇后	an empress
黄昏	dusk; evening; nightfall
恍然大悟	suddenly see the light; suddenly realize what has happened; twig
晃	to sway; to shake
挥霍	squander money without restraint; squander
辉煌	splendid; glorious
回报	repayment; payback
回避	avoid; shun; evade
回顾	look back; to review
回收	recycle; recover and put back to use
悔恨	remorse; repentance
毁灭	perish; ruin; destroy
汇报	report; give an account of; to collect information and report back
会晤	meet; meeting; conference
贿赂	to bribe
昏迷	lose consciousness; be in a coma
荤	meat or fish dish; pungent vegetables forbidden to Buddhist vegetarians
浑身	entire body; from head to foot
混合	to mix; to blend
混乱	confusion; chaotic
混淆	obscure; confuse; mix up; blur; mislead; confusing
混浊	muddy; dirty; turbid
活该	serve sb. right; deservedly; ought
活力	energy; vitality; vigor
火箭	rocket
火焰	blaze; flame
火药	gunpowder
货币	currency; money
讥笑	sneer at; deride
饥饿	hunger; hungry; starve
机动	motorized; mobile; flexible
机构	structure; organization; institution
机灵	clever; quick-witted; smartness
机密	secret; classified (information)
机械	machine; mechanical
机遇	opportunity; stroke of good luck; favorable circumstance
机智	tact; quick-witted; resourceful
基地	base (of operations)
基金	fund; endowment
基因	gene
激发	to arouse; excite
激励	urge; encourage; motivation
激情	passion; strong emotion; fervor; enthusiasm
及早	as soon as possible; at the earliest possible time
吉祥	lucky
级别	rank; level; grade
极端	extreme
极限	limit; extreme boundary
即便	even if; even though
即将	will shortly; soon; be on the verge of
急功近利	eager for success and profit
急剧	rapid; sudden
急切	eager; impatient; imperative
急于求成	impatient for success
急躁	irritable; impetuous; impatient
疾病	disease; illness; sickness; ailment
集团	group; bloc; circle; clique
嫉妒	to be jealous; to envy, covet; to hate; to begrudge
籍贯	place of one's ancestry
给予	to give
计较	focus excessively on; haggle; bicker; argue
记性	memory
记载	write down; to record
纪要	written summary of a meeting; minutes
技巧	skill; technique
忌讳	avoid as a taboo; abstain from; taboo
季度	(financial) quarter; period of three months
季军	third in a race; bronze medalist
迹象	mark; indication; sign
继承	inherit; carry on; succeed
寄托	entrust somebody someone's care; consign; commit
寂静	quiet
加工	to process; processing; machining
加剧	aggravate; intensify; sharpen; accelerate
夹杂	mix together; have two dissimilar substances mixed together
佳肴	delicacy
家常	the daily life of a family; home-style (food)
家伙	guy; chap; tool; weapon
家属	family member; a dependent
家喻户晓	become a household name; well-known
尖端	highest peak; the tip; sharp pointed end; most advanced and sophisticated
尖锐	sharp; intense; penetrating
坚定	firm; staunch; resolute
坚固	firm; strong; sturdy
坚韧	tough and durable; hard-bitten; firm and tenacious
坚实	firm and substantial; solid
坚硬	hard; solid
艰难	difficult; arduous
监督	control; monitor; supervise; inspect
监视	oversee; to monitor
监狱	prison; jail
煎	pan-fry; fry in shallow oil
拣	choose; select; sort out
检讨	self-criticism; analyze
检验	inspect; examine; to test
剪彩	cut the ribbon at an opening ceremony
简化	simplify; simplification
简陋	simple and crude (i.e. room or building)
简体字	simplified Chinese characters
简要	concise; brief
见多识广	experienced and knowledgeable
见解	view; opinion; understanding
见闻	information
见义勇为	to see what is right and act courageously (idiom, from Analects); to stand up bravely for the truth; acting heroically in a just cause
间谍	a spy; intelligence agent
间隔	interval; intermission; gap; be separated
间接	indirect
剑	sword
健全	Perfect; sound; to perfect/strengthen/amplify
舰艇	warship; naval vessel
践踏	trample
溅	to splash
鉴别	differentiate; distinguish
鉴定	appraise; identify; evaluate
鉴于	in light of; in view of; seeing that
将近	almost; nearly; close to
将就	put up with; accept somewhat reluctantly
将军	a general (military officer)
僵硬	stiff
奖励	to reward (as encouragement)
奖赏	to reward
桨	oar; paddle
降临	befall; descend
交叉	cross; intersect
交代	explain; account for; hand over
交涉	negotiate; discuss a matter with the opposing side
交易	business transaction; deal; trade
娇气	delicate; effeminate; squeamish
焦点	focus; focal point
焦急	anxiety; worried
角落	corner; nook
侥幸	by luck; by a fluke
搅拌	stir; mix up
缴纳	to pay (taxes)
较量	competition; to have a contest with sb.
教养	upbringing; education; bring up; nurture and train
阶层	hierarchy
皆	all; each and every; in all cases
接连	one after another; in a row; in succession
揭露	expose; unmask
节制	to be restrained or moderate
节奏	rhythm; cadence; tempo
杰出	outstanding; preeminent
结晶	a crystal; to crystallize
结局	conclusion; ending
结算	settle up the bill; close an account
截止	end; close; stop; expiration
截至	up until; by (a specified time
竭尽全力	to spare no efforts; do one's utmost
解除	remove; relieve (someone of their duties); sack; get rid of
解放	liberate
解雇	fire; lay off; dismiss from
解剖	dissect; analyze; anatomy
解散	dismiss; dissolve; disband
解体	disintegrate
戒备	take precautions; be on the alert
界限	boundary; marginal; limit
借鉴	take example by; use other people's experience
借助	get help from
金融	banking finance; financial
津津有味	(saying) with gusto; eagerly; with great interest
紧迫	urgent; urgency
锦上添花	lit. on brocade, add flowers (idiom); to decorate sth already perfect / gilding the lily
进而	and then (what follows next)
进攻	attack (military); assault
进化	evolution
进展	make progress; development; make headway
近来	recently; lately
晋升	promote to a higher position
浸泡	to soak
茎	stalk; stem
经费	funds; expenses
经纬	warp and woof; longitude and latitude; main points
惊动	alarm; alert; startle; disturb
惊奇	amaze; astonished
惊讶	surprised; astonished; astound
兢兢业业	cautious and conscientious
精打细算	(saying) meticulous planning and careful accounting
精华	elite; best feature; most important part of an object; essence; quintessence
精简	simplify; reduce
精密	accuracy; exact; precise; refined
精确	accurate; precise
精通	proficient; have a good command of
精心	with utmost care; meticulous; detailed
精益求精	(saying) improving and wanting to improve even more
精致	exquisite; delicate; refined
井	a well
颈椎	cervical vertebra; the seven cervical vertebrae in the neck of humans and most mammals
警告	to warn; admonish
警惕	vigilant; alert; be on guard
竞赛	race; contest; competition
竞选	run for (electoral) office; take part in an election
敬礼	to salute; best regards
敬业	work ethic
境界	boundary; state; realm; level
镜头	camera shot (in a movie, etc.); scene; camera lens
纠纷	dispute; quarrel
纠正	to correct; to make right
酒精	alcohol; ethanol
救济	emergency relief; aid; help out in a disaster
就近	nearby; in a close neighborhood
就业	employment; getting a job
就职	take office; assume a post
拘留	detain (a prison); keep (someone) in custody
拘束	restrict; constrained; ill at ease; reticent
居民	resident; inhabitant
居住	reside; dwell; to live (in a place)
鞠躬	to bow
局部	part; local
局面	aspect; situation
局势	situation; state (of affairs)
局限	to limit; confine; restrict or confine sth.
咀嚼	to chew
沮丧	dejected; depressed; dispirited
举动	action; act; (make) a move; movement
举世瞩目	attract worldwide attention
举足轻重	a foot's move sways the balance; hold the balance of power; play a key role
剧本	script for a play; opera; movie; etc
剧烈	acute; violent; severe
据悉	according to reports; it is reported (that)
聚精会神	concentrate one's attention
卷	to roll (up); to coil; (mw for tapes)
决策	Make policy; make strategic decision
觉悟	consciousness; awareness; (Buddhist) enlightenment
觉醒	awaken; arousal; realize
绝望	desperation; forlorn; hopeless
倔强	stubborn; unbending
军队	army troops
君子	gentleman; man of noble character
卡通	cartoon
开采	extract ore or some other natural resource from a mine
开除	expel; to discharge; to kick out
开阔	wide; open (spaces)
开朗	outgoing and cheerful; optimistic; carefree; spacious and well-lit
开明	enlightened; open-minded
开辟	open up; to start; to build
开拓	break new ground (for agriculture); development
开展	begin to develop; to launch
开支	expenditures; pay; expenses
刊登	publish in a newspaper; carry a story
刊物	publication; periodical; journal
勘探	exploration
侃侃而谈	speak frankly and in measured tones; argue about leisurely and boldly
砍伐	cut down; lop; hew (as a tree)
看待	look upon; regard
慷慨	vehement; fervent; generous
扛	to carry on one's shoulder
抗议	to protest; protest
考察	inspect; investigate; analyze
考古	archaeology
考核	examine; check up on
考验	put to the test; trial
靠拢	draw close; close up; move up
科目	(school) subject
磕	knock; tap
可观	considerable; impressive
可口	tasty; taste good
可恶	hateful; abominable; repulsive
可行	feasible
渴望	wishful; to yearn for; desire
克制	restrain; take a firm hold on
刻不容缓	demand immediate action; brook no delay
客户	customer; account; client
课题	task; problem; issue; question for discussion
恳切	earnest; genuine; fair-spoken
啃	gnaw; nibble; bite
坑	pit; hole; defraud
空洞	empty; hollow; vacuous; devoid of content
空前绝后	unprecedented and unrepeatable; never to be reduplicated; the first and the last; unmatched; unique
空想	daydream; fantasy
空虚	hollow; emptiness; meaningless
孔	hole
恐怖	afraid; terror
恐吓	to threaten
恐惧	fear; dread; phobia
空白	blank space; blank
空隙	crack; gap between two objects
口气	tone of voice; manner of speaking
口腔	space inside mouth (oral cavity)
口头	oral; verbal
口音	accent
扣	to fasten; to button; button; buckle; knot; to arrest; to confiscate; to deduct (money); discount; to knock; put upside down; to smash or spike (a ball); to cover (with a bowl etc); fig. to tag a label on sb
枯萎	wither; withered
枯燥	dry and dull; uninteresting
哭泣	weep; cry; sob
苦尽甘来	sweetness comes after bitterness; the hard times are over and the good times are just beginning
苦涩	bitter and astringent; pained; agonized; anguished
挎	carry over one's shoulder or slung on one's side
跨	step across; stride; straddle; to cross
快活	happy; cheerful
宽敞	spacious; commodious
宽容	tolerant; lenient
款待	to entertain (guests)
款式	pattern; design; style
筐	basket
旷课	cut school; be truant from school
况且	moreover; besides; in addition
矿产	minerals
框架	frame; framework; skeleton
亏待	treat sb. unfairly
亏损	deficit; (financial) loss
捆绑	tie up; bundled
扩充	expand; extend
扩散	spread; proliferation
扩张	expansion; extension
喇叭	horn; trumpet; loudspeaker
蜡烛	candle
啦	sentence-final particle: a contraction of 了 (le) and 啊 (a)
来历	history; antecedents; origin
来源	source; originate
栏目	column (in a newspaper,TV,etc)
懒惰	lazy; idle
狼狈	in a difficult position or situation; in a tight corner; scoundrel! (derogatory)
狼吞虎咽	wolf down one's food (idiom); gorge oneself
捞	dredge up; fish up
牢固	firm; secure; solid
牢骚	grumble; complaint
唠叨	be talkative (especially about trivial matters); be garrulous; prattle
乐趣	delight; pleasure; joy; fun
乐意	be happy/willing do something; content; satisfied
雷达	radar
类似	similar; analogous
冷酷	grim; unfeeling; callous
冷落	to treat somebody coldy; to snub; desolate; to give the cold shoulder
冷却	cooling; cool off
愣	dumbfounded; stupefied; distracted; (spoken) blunt; rash
黎明	dawn; daybreak
礼节	etiquette; proprieties; festival
礼尚往来	courtesy requires reciprocity
里程碑	milestone
理睬	heed; pay attention to (usually used in the negative)
理所当然	(idiom) it goes without saying; certainly; of course; be natural and right
理直气壮	with justice on one's side, one is bold and assured; to have the courage of ones convictions; just and forceful
理智	reason; intellect; rational
力求	make every effort; do one's best
力所能及	within one's power; to the best of one's ability
力争	work hard; do all one can to; strive for/argue strongly
历代	successive dynasties; past dynasties
历来	always; throughout (a period of time)
立场	position; standpoint
立方	cube; (mw cubic units of measure)
立交桥	overpass; one road goes on top of another; cloverleaf intersection
立体	solid; three dimensional
立足	base oneself on; be established; have a footing
利害	serious; formidable; devastating; (-hài: advantages and disadvantages)
例外	(make an) exception
粒	a grain; granule; (mw for grain-like things)
连年	successive years; over many years; once again this year
连锁	chain (store etc); to interlock
连同	together with; along with
联欢	have a get-together
联络	communication; to contact
联盟	alliance; union; coalition
联想	to associate (cognitively); to make an associative connection; mental association; word prediction and auto-complete functions of input method editing programs; abbr. for 联想集团 Lenovo Group (PRC computer firm)
廉洁	honest; incorruptible
良心	conscience
谅解	understanding; make an allowance for; forgive
晾	dry in the air/sun; (colloquial) snub or ignore
辽阔	vast; extensive
列举	make a list; enumerate
临床	clinical
淋	to drain; to drip; drench
吝啬	stingy; mean; miserly
伶俐	clever; witty; intelligent
灵感	inspiration; insight; a burst of creativity in scientific or artistic endeavor
灵魂	soul; spirit; conscience
灵敏	sensitive
凌晨	early in the morning
零星	partial; scattered; fragmentary
领会	understand; comprehend; grasp
领事馆	consulate
领土	territory
领悟	comprehend; grasp; fathom
领先	leadership; to lead; be in front
领袖	leader
溜	slip away; to skate; to glide
留恋	be reluctant to leave
留念	to keep as a souvenir
留神	(idiom) take care to ...; be careful of ...
流浪	drift about; wander
流露	express; reveal (one's thoughts or feelings)
流氓	rogue; hooligan; gangster
流通	circulate; currency
聋哑	deaf and dumb; deaf-mute
隆重	grand; prosperous; ceremonious
垄断	monopoly
笼罩	envelop; to shroud; be masked by
搂	to hug; to embrace
炉灶	kitchen range; cooking range; stovetop range
屡次	repeatedly; time and again; frequently
履行	fulfill (one's obligations); carry out
掠夺	to plunder; rob; pillage
轮船	steamship
轮廓	outline; silhouette
轮胎	tire (of a wheel)
论坛	forum
论证	prove a point; expound on; argumentation
啰唆	long-winded; wordy; troublesome; pesky
络绎不绝	endless stream
落成	complete a construction project
落实	workable; implement
麻痹	paralysis; palsy; numbness
麻木	numb
麻醉	anesthesia
码头	dock; wharf
蚂蚁	ant
嘛	(used to persuade somebody to do something); (particle indicating obviousness); (colloqial) what?
埋伏	ambush; lie in ambush
埋没	oblivion; bury; neglect
埋葬	bury
迈	to step; stride
脉搏	pulse; throbbing
埋怨	complain; blame; connotes sb or sth is to blame
蔓延	extend; spread; to creep
漫长	very long; endless
漫画	comics; manga
慢性	slow and patient; chronic (disease)
忙碌	be busy; bustling
盲目	blindness; aimless
茫茫	boundless; vast and obscure
茫然	unseeing; ignorant; have no knowledge of sth.
茂盛	exuberance; luxuriant
冒充	pretend to be (somebody or something else); pass (somebody or something) off as; impersonate
冒犯	to offend
枚	(mw for coins, rings, medals)
媒介	media; medium
美观	pleasing to the eye; beautiful; artistic
美满	happy; blissful
美妙	beautiful (when describing a work of art); wonderful; splendid
萌芽	sprout; bud; germ of a plant
猛烈	fierce; violent
眯	to squint; to take a nap
弥补	make up for a deficiency; remedy; offset
弥漫	fill the air; permeate; to suffuse
迷惑	to puzzle; confuse; mystify
迷人	charming; enchanting; cute
迷信	superstition; be superstitious
谜语	riddle; conundrum
密度	density; thickness; consistency
密封	seal up; pressurize
棉花	cotton
免得	so as not to; so as to avoid
免疫	immune
勉励	encourage
勉强	reluctantly; grudgingly; force sb. to do sth.
面貌	appearance; looks; features
面子	honor; reputation; prestige; face
描绘	describe; portray
瞄准	take aim (a weapon at a target)
渺小	tiny; minute; negligible
藐视	treat with contempt
灭亡	be destroyed; perish; exterminate; become extinct
蔑视	despise; loathe; disparage; scorn
民间	among the people; popular; folk
民主	democracy
敏捷	nimble; agile; shrewd
敏锐	keen; sharp; acute; brisk
名次	position in a ranking of names
名额	particular number of people; quota
名副其实	not just in name only; but also in reality
名誉	fame; reputation; honor; honorary
明明	obviously; plainly; undoubtedly
明智	wise
命名	give a name; to dub; christen; naming
摸索	feel about; grope around; fumble
模范	model; exemplar
模式	model; pattern; method
模型	model; mould; matrix; pattern
膜	membrane; film
摩擦	friction; clash (between two parties); conflict
磨合	adapt gradually to each other; to consult; break in; wear in
魔鬼	devil; demon; monster
魔术	magic
抹杀	write off; erase; remove from evidence
莫名其妙	odd; baffling; unaccountable
墨水	ink
默默	in silence; not speaking
谋求	seek; strive for; try to get
模样	appearance; form; approximation
母语	native/mother tongue
目睹	witness; see first hand
目光	sight; vision; view
沐浴	take a bath; revel; immerse
拿手	good at; adept
纳闷	feel puzzled; bewildered
耐用	durable
南辕北辙	at odds with; act in a way that defeats one's purpose
难得	hard to come by; difficult to get; rare
难堪	hard to take; endure; embarrassed
难能可贵	estimable; extremely good
恼火	get angry; irritated; annoy
内涵	connotation
内幕	inside story; non-public information; behind the scenes
内在	intrinsic; innate
能量	energy; capabilities
拟定	make an initial draft; draw up
逆行	go/drive against the traffic; go in the wrong direction; regress; retrograde
年度	year (e.g. school year, fiscal year, etc.); annual
捏	to pinch (with one's fingers); knead
凝固	curdle; freeze; solidify; congeal
凝聚	agglomeration; agglomerate; cohesion; coherence
凝视	gaze; stare
拧	wring; to pinch
宁肯	would rather ...; it would be better
宁愿	would rather; better
扭转	to reverse; turn around (an undesirable situation)
纽扣	button
农历	agricultural calendar; lunar calendar
浓厚	dense; thick (fog, clouds, etc.)
奴隶	slave
虐待	to abuse; maltreat; tyrannize
挪	shift; move
哦	oh (indicates understanding)
殴打	beat up; hit
呕吐	to vomit; retch; nausea
偶像	Idol
趴	lie on one's stomach
排斥	to reject; repulse; exclude
排除	eliminate; get rid of; remove
排放	to discharge; emit
排练	to rehearse
徘徊	pace back and forth; hesitate; waver
派别	denomination; group; school; faction; school of thought; sect
派遣	send (on a mission); dispatch
攀登	to climb; clamber; to pull oneself up
盘旋	spiral; coil; circle; go around
判决	judgment (by a court of law); adjudicate
畔	riverbank; side; boundary
庞大	enormous; huge; tremendous
抛弃	discard; abandon; dump (sb)
泡沫	foam; (soap bubble); (economic) bubble
培育	to train; nurture; to breed
配备	provide; outfit with
配偶	mate; consort; spouse
配套	form a complete set
盆地	basin
烹饪	cooking; culinary arts
捧	hold or carry with both hands facing up
批发	wholesale
批判	criticize; critique
劈	split in two; to divide
皮革	leather
疲惫	beaten; exhausted; tired
疲倦	tired; weary
屁股	butt; rear; rump
譬如	for example; for instance; such as
偏差	bias; deviation
偏见	prejudice
偏僻	remote and isolated; far from the city
偏偏	unexpectedly; contrary to expectations
片断	part; passage; extract; fragment; snatch
片刻	a short period of time
漂浮	superficial; float; hover; drift
飘扬	wave in the wind; flutter; fly
撇	left-curving stroke (丿); throw; fling
拼搏	struggle; wrestle
拼命	risk one's life; desperately; with all one's might
贫乏	lacking; incomplete
贫困	poor; impoverished
频繁	frequently; often
频率	frequency
品尝	try; taste a small amount; to sample
品德	moral character; morality; morals
品质	quality; character
品种	breed; variety
平凡	commonplace; ordinary
平面	a plane (i.e. flat surface); type; category
平坦	flat
平行	parallel; concurrent
平庸	mediocre
平原	field; plain; flatlands
评估	evaluate
评论	comment on; discuss; remark
屏幕	screen (TV, etc.)
屏障	wall; barrier; protective screen
坡	slope
泼	to splash; to spill; rude and unreasonable; brutish
颇	rather; quite; inclined to one side
迫不及待	be too impatient to wait
迫害	persecute; persecution
破例	make an exception
魄力	daring resolution; boldness; courage
扑	to assault; rush at; throw oneself on
铺	bed; store; to spread; to lay
朴实	plain; sober; down-to-earth
朴素	plain; simple; austerity
普及	widespread; popular; popularize
瀑布	waterfall
凄凉	desolate; feel like no one likes you
期望	hope; expectation
期限	time limit; deadline; allotted time
欺负	to bully; intimidate
欺骗	deceive; to cheat; to dupe
齐全	complete
齐心协力	make concerted efforts
奇妙	wonderful; fantastic
歧视	discriminate (against someone)
旗袍	cheongsam; Chinese-style dress
旗帜	flag; banner
乞丐	beggar
岂有此理	outrageous; ridiculous; absurd
企图	(to ) attempt; try; attempt
启程	set out on a journey
启蒙	enlighten; enlightenment； instruct the young; to initiate
启示	enlightenment; revelation
启事	announcement; public information (usually posted on a billboard)
起草	draft (a bill); draw up (plans)
起初	at first; originally; in the beginning
起伏	ups and downs; with a wavy motion
起哄	gather together; cause a commotion
起码	at the minimum; at the very least
起源	origin; originate; come from
气概	mettle; spirit; gumption
气功	Qi Gong, a system of deep breathing exercises
气魄	spirit; daring; nerve; boldness; enterprising outlook
气色	complexion
气势	imposing manner; look of great force or imposing manner
气味	odor; scent
气象	meteorology; atmosphere; phenomenon
气压	atmospheric pressure; barometric pressure
气质	temperament; disposition
迄今为止	until now; so far; to date
器材	equipment; material
器官	organ; apparatus
掐	pick (flowers); pinch; clutch
洽谈	discuss; talk over
恰当	appropriate; suitable; proper
恰到好处	just right; it's just perfect
恰巧	happen by chance; coincidence
千方百计	by every possible means
迁就	humor; yield; adapt to; accommodate (something)
迁徙	migrate; move; change one's residence
牵	to lead along; to pull (an animal on a tether)
牵扯	implicate; involve
牵制	control; curb; restrict; impede
谦逊	humble; modest; humility
签署	sign (an agreement)
前景	outlook; future (prospects); foreground
前提	premise; precondition
潜力	potential; capacity
潜水	go diving
潜移默化	exert a subtle influence on sb.'s character, thinking, etc.; impercebtibly influence; to influence secretly
谴责	denounce; condemn; criticize
强制	enforce; control; coerce
抢劫	rob; looting
抢救	rescue; to save
强迫	compel; to force
桥梁	bridge
窍门	special tricks
翘	stick up; bend upwards
切实	realistic; feasible; conscientiously
锲而不舍	keep on chipping away; work with perseverance
钦佩	admire; have great respect for
侵犯	encroach on; infringe on; violation
侵略	invasion; encroachment; invade
亲密	intimate; close; familiarity
亲热	intimate; affectionate; warm
勤俭	hardworking and thrifty
勤劳	hardworking; diligent; industrious
倾听	listen attentively; heed (other people's opinions)
倾向	trend; tendency; inclination
倾斜	incline; lean; to slant; to slope; to tilt
清澈	clear; limpid
清晨	early morning
清除	eliminate; get rid of
清洁	clean; unpolluted; purity
清理	cleanup; put in order; check up
清晰	clear; distinct; clarity
清醒	clear-headed; sober; regain consciousness
清真	Muslim
情报	intelligence; information-gathering
情节	plot; circumstances
情理	reason; sense
情形	circumstances; situation
晴朗	sunny and cloudless
请柬	invitation card; written invitation
请教	consult; seek advice
请示	ask for instructions
请帖	invitation card; written invitation
丘陵	hills
区分	differentiate; find differing aspects; find the difference between
区域	area; region; district
曲折	winding; zigzag; complicated
驱逐	banishment; expel; deport
屈服	yield; give in; submit
渠道	irrigation ditch; medium or channel of communication
曲子	folk tune; music; melody
取缔	to ban; suppress
趣味	fun; interest; delight; taste
圈套	trap
权衡	trade-off; weigh pros and cons
权威	authority; authoritative
全局	overall situation
全力以赴	do at all costs; make an all-out effort
拳头	fist
犬	dog
缺口	gap; breach; shortfall
缺席	absence; absent; default
缺陷	a defect; a flaw; disfigurement
瘸	lame
确保	ensure; guarantee
确立	to establish; to institute
确切	definite; exact; precise
确信	confident; be certain of; to firmly believe
群众	the masses; multitude
染	dye; to catch (a disease)
嚷	blurt out; shout
让步	give in; concede; yield
饶恕	forgive; pardon; spare
扰乱	disturb; perturb; harass
惹祸	stir up troubles
热泪盈眶	(saying) eyes brimming with tears; extremely moved
热门	in demand; popular; in vogue
人道	humanitarianism; humane
人格	personality; moral integrity; character
人工	man-made; manpower; manual work
人家	other people; others; they; I; family; household
人间	man's world; the world
人士	person; public figure
人为	artificial; man-made
人性	human nature; humanity
人质	hostage
仁慈	benevolent; kindhearted; charitable
忍耐	show restraint; endure; exercise patience
忍受	to bear; endure; tolerate
认定	maintain (that sth. is true); firmly believe
认可	approve; accept; ratify
任命	appoint and nominate
任性	willful; headstrong
任意	arbitrarily; at will; at random
任重道远	lit. a heavy load and a long road; fig. to bear heavy responsibilities through a long struggle; shoulder heavy responsibilities
仍旧	still (remaining); remain (the same); yet
日新月异	change with each passing day
日益	day by day; more and more; increasingly
荣幸	honored
荣誉	honor; glory
容貌	facial features; looks; appearance
容纳	contain; accommodate; tolerate (different options)
容器	container; receptacle; vessel
容忍	put up with; tolerate; condone
溶解	dissolve; solution
融化	melt; thaw; dissolve; blend into
融洽	harmonious; friendly relations
柔和	gentle; soft; mild
揉	knead; to massage; to rub
儒家	Confucianism
若干	a certain number or amount; how many; how much
弱点	weak point; failing
撒谎	to tell lies
散文	prose; essay
散布	to scatter; disseminate; to spread
散发	distribute; emit
丧失	to lose; to forfeit
骚扰	harass; disturb; molest; cause a commotion
嫂子	(informal) elder brother's wife; sister-in-law
刹车	brake (when driving); stop; switch off
啥	(spoken) what
筛选	to filter; to sift
山脉	mountain range
闪烁	to twinkle; to flicker; glimmer
擅长	be good at; be expert in
擅自	unauthorized
伤脑筋	troublesome; bothersome
商标	trademark; logo
上级	higher authorities; superiors
上进	make forward progress; do better
上任	take office
上瘾	become addicted; get into a habit
上游	upper reaches (of a river); advanced position
尚且	yet; still; even; also
捎	bring or take (along); deliver (a message)
梢	tip of a branch
哨	a whistle; sentry post
奢侈	luxury; sumptuous; extravagant
舌头	tongue
设立	set up; establish
设想	imagine; consider; tentative plan
设置	set up; install; to fit
社区	community
涉及	involve; relate to; to touch upon (a topic)
摄氏度	degrees Celsius
申报	declare; report (to customs or other authority)
呻吟	to moan; to groan
绅士	gentleman
深奥	profound; deep
深沉	deep; extreme; low pitched (sound); grave; of major importance
深情厚谊	profound friendship
神经	nerve
神奇	miraculous; magical; mystical
神气	expression; manner; spirited
神圣	divine; holy; sacred
神态	appearance; looks; manner; expression
神仙	fig. lighthearted person; Daoist immortal; supernatural entity; (in modern fiction) fairy, elf, leprechaun, etc.; supernatural being, celestial being, immortal; a person who has the power of clairvoyance or who is free from worldly cares
审查	examine; investigate; censorship
审理	hear (a case)
审美	aesthetic sense; appreciation of the arts
审判	put (someone) to trial; to try somebody
渗透	infiltrate; permeate
慎重	cautious; careful; prudent
生存	exist; survive
生机	reprieve from death; life force; vitality
生理	physiology
生疏	unfamiliar; strange; out of practice
生态	way of life; ecology
生物	organism; living creature; life form
生肖	Chinese zodiac
生效	take effect; become effective
生锈	to rust
生育	give birth; to rear; bring up (children)
声明	statement; declare; proclaim
声势	momentum; fame and power; prestige
声誉	reputation; fame
牲畜	livestock; domesticated animals
省会	provincial capital
胜负	victory or defeat; the outcome of a battle
盛产	abound in; teem with; superabundant
盛开	to bloom; be in full flower
盛情	great kindness; boundless hospitality
盛行	in fashion; prevalent; prevail
尸体	dead body; corpse; carcass
失事	be involved in a crash; (have an) accident
失误	mistake; lapse; miss
失踪	be missing; be unaccounted for
师范	teacher-training; pedagogical; normal (school)
施加	exert (effort or pressure)
施展	use fully; put to good use
十足	full of; complete; 100 percent
石油	oil; petroleum
时常	time and again; often; frequently
时而	occasionally; often, but not at any fixed time
时光	time; era; period of time
时机	opportune time; opportunity
时事	current events; the present situation
识别	identify; distinguish; discern
实惠	substantial material benefit; advantageous (deal)
实力	strength
实施	to implement; put into effect; carry out
实事求是	be practical and realistic; seek truth from facts
实行	to implement; put into practice; carry out
实质	substance; essence; gist
拾	pick up; ten (banker's anti-fraud numeral)
使命	a (diplomatic or other) mission
示范	demonstrate; lead the way; show how something is done
示威	hold a protest demonstration
示意	to signal; to hint; to gesture; to motion; to indicate (an idea to sb)
世代	for generations; generation to generation
势必	is bound to (happen)
势力	power; influence
事故	accident
事迹	achievement; deed
事件	event; happening; incident
事态	situation; existing state of affairs
事务	affairs; work
事项	matter; item
事业	undertaking; project; cause; enterprise
试图	to try; to attempt
试验	experiment; test
视力	vision; eyesight
视频	video
视线	line of sight; view line
视野	field of vision
是非	right and wrong; truth and fiction; quarrel
适宜	suitable for; appropriate for
逝世	pass away; to die
释放	release; set free; liberate (a prisoner)
收藏	collect; keep
收缩	pull back; shrink
收益	earnings; profit
收音机	radio
手法	technique; trick; skill; tact
手势	gesture; sign; signal
手艺	craft; workmanship; one's cooking
守护	guard; defend; protect
首饰	jewelry
首要	the most important; chief; principal
受罪	endure hardships; have a hard time
授予	to award; confer
书法	calligraphy; penmanship
书籍	books; works
书记	secretary; clerk
书面	in writing; written (guarantee, etc.)
舒畅	happy; entirely free from worry
疏忽	neglect; overlook; negligence
疏远	drift apart; keep at a distance; not in close touch; estranged
束	to tie; to bind; restrain; (mw for bunches, bundles, bouquets, etc.)
束缚	to bind; restrict; to tie
树立	set up; establish
竖	vertical; to erect; vertical stroke
数额	amount; sum of money; fixed number
耍	play/mess around with; juggle
衰老	grow old; age; deteriorate
衰退	decline; fall; drop; falter
率领	lead; command; head
涮火锅	to instant-boil (mutton, beef, vegetables, etc.)
双胞胎	twins
爽快	refreshed; rejuvenated; frank
水利	water conservancy; irrigation works
水龙头	faucet; tap
水泥	cement
瞬间	in the twinkling of an eye; in an instant; momentary
司法	judicial; (administration of) justice
司令	commanding officer
私自	private; secretly; without permission
思念	think of; long for; to miss
思索	think deeply; ponder
思维	(line) of thought; thinking
斯文	refined; educated; cultured; intellectual; men of letters; scholars; literati; polite; gentle
死亡	to die; death; be dead
四肢	arms and legs; the four limbs of the body
寺庙	temple; monastery
饲养	to raise; to rear (domestic animal)
肆无忌惮	absolutely unrestrained; unbridled; without the slightest scruple
耸	shrug; towering; shock (alarm)
艘	(mw for boats and ships)
苏醒	wake up; regain consciousness
俗话	common saying; proverb
诉讼	lawsuit
素食	vegetables; vegetarian food
素质	inner quality; basic essence; character quality
塑造	to shape; mould; figure
算数	(do) arithmetic; count
随即	immediately (after); soon after; immediately
随意	as one wishes; according to one's wishes
岁月	the years of a person's life
隧道	tunnel
损坏	to damage; injure
索取	demand; ask for; to exact
索性	you might as well (do it); simply; just; frankly; bluntly; directly
塌	collapse; fall down; crumple
踏实	practical; down-to-earth; realistic; feel at ease; steadfast
塔	pagoda; tower
台风	typhoon
太空	outer space
泰斗	leading scholar of his time; magnate
贪婪	greedy; avaricious
贪污	(political, moral) corruption; embezzle
摊	to spread out; vendor's stand; booth; fry; (mw for puddles)
瘫痪	paralysis
弹性	flexibility; elasticity
坦白	honest; forthcoming; to confess
叹气	to sigh
探测	probe; take readings; detect; explore
探索	explore; quest
探讨	inquire into; explore
探望	pay a visit; look around
倘若	provided that; supposing that; if; in case
掏	fish out (from pocket)
滔滔不绝	(saying) talking non-stop; gushing; torrential
陶瓷	ceramics; pottery and porcelain
陶醉	be intoxicated (with power, success, etc.)
淘汰	eliminate (in a competition); natural selection; die/phase out
讨好	to flatter
特长	strong point; specialty
特定	special; specific; designated
特意	specially for; with the special intention of
提拔	promote to a higher job; elevate
提炼	extract (ore, minerals, etc.); refine; purify
提示	to prompt; to present; to point out; to draw attention to sth; hint; brief; cue
提议	propose; suggest
题材	subject matter
体裁	types or forms of literature
体积	volume; bulk
体谅	empathize; express sympathy; allow (for something)
体面	dignity; honorable; face
体系	system; setup
天才	talent; gift; a genius; talented
天赋	natural talent
天伦之乐	family happiness
天然气	natural gas
天生	innate; inherent; natural
天堂	paradise; heaven
天文	astronomy
田径	track and field
田野	field; open country
舔	to lick
挑剔	picky; fastidious
条款	clause (of contract or law)
条理	consecutive; arrangement; orderliness
条约	treaty; pact
调和	harmonious; harmony
调剂	make an adjustment
调节	adjust; regulate; reconcile
调解	mediation; bring together to an agreement
调料	seasoning; flavoring
挑拨	incite disharmony; provoke; stir up tension in others
挑衅	provoke; defiance
跳跃	jump; leap; bound; skip
亭子	pavilion; kiosk
停泊	anchor; mooring (of a ship)
停顿	pause; halt
停滞	stagnation; be at a standstill; bogged down
挺拔	tall and straight
通货膨胀	inflation
通缉	order the arrest of a criminal
通俗	popular; common; everyday; average; vulgar
通讯	communication; correspondence; news dispatch
通用	in common use; interchangeable; General Motors
同胞	compatriot; fellow countryman
同志	comrade; gay (slang)
铜	copper
童话	fairy tale
统筹兼顾	take every aspects into consideration through plan and preparation
统计	statistics; to tally; to add up
统统	totally; completely
统治	to rule (a country); govern; governance
投机	speculate (on financial markets); congenial; opportunistic
投票	vote; poll
投诉	make a complaint; appeal to a court
投降	to surrender
投掷	throw something a long distance; hurl
透露	divulge; to reveal; leak out
秃	bald; blunt
突破	break through; breakthrough
图案	design; pattern
徒弟	disciple
途径	way; channel
涂抹	scribble; smear; doodle
土壤	soil; earth
团结	unite; hold a rally; join forces
团体	group; organization; team
团圆	have a reunion; reunite as a family
推测	speculate; conjecture; surmise
推翻	overthrow; topple
推理	reasoning; speculative; inference
推论	infer; a deduction; a corollary
推销	to market; sell
吞吞吐吐	hum and haw (idiom); mumble as if hiding something; speak and break off, then start again; to hold something back
托运	check in (baggage); consign for shipment
拖延	prolong; protraction; delay; stall; procrastinate
脱离	to separate oneself from; to break away from; be divorced from; diastasis (medicine); abscission; abjunction (botany)
妥当	appropriate; proper; pertinence
妥善	appropriate; proper; well-arranged
妥协	to compromise; reach terms
椭圆	ellipse; oval
唾弃	cast aside; spurn
挖掘	excavate; dig; unearth
哇	wow; (sound of crying or surprise)
娃娃	baby; child; doll
瓦解	collapse; disintegrate; crumble
歪曲	to distort; to misrepresent; to twist; crooked; askew; aslant
外表	outward appearance; external; outside
外行	layman; amateur; nonprofessional
外界	the outside world; external
外向	extroverted; export-oriented (economy)
丸	pill; pellet
完备	complete; perfect
完毕	finish; end; complete
玩弄	resort to; play with; engage in
玩意	thing; toy; gadget
顽固	stubborn; obstinate
顽强	tenacious; hard to defeat
挽回	reverse or salvage (a situation); redeem; retrieve
挽救	to rescue; retrieve; to remedy
惋惜	feel sorry for a person; sympathize; to regret
万分	very much; extremely
往常	habitually in the past; as one used to do; as it used to be
往事	the past events; former happenings
妄想	vainly hope; wishful thinking; delusion
危机	crisis
威风	awe-inspiring authority; power and prestige; impressive force
威力	might; power that invokes fear
威望	prestige
威信	prestige; reputation; veneration; authority; trust
微不足道	negligible; insignificant; not worth mentioning
微观	microscopic; sub atomic
为难	make things difficult for someone; embarrassed
为期	be scheduled for; last for (a certain duration)
违背	violate; go against
唯独	only; just (i.e. it is only that ...); alone
维持	maintain; preserve
维护	defend; to safeguard; defense; maintain
维生素	vitamin
伪造	forge; to fake; to counterfeit
委托	to entrust; to trust; to ensign; to commission
委员	committee member; committee; council
卫星	satellite
未免	(of something that one finds has gone too far); rather a bit too
畏惧	to fear; foreboding
喂	hey; to feed; hello (on the phone)
蔚蓝	azure; sky blue
慰问	to express sympathy; consolation; extend regards to; salute
温带	temperate zone
温和	moderate; warm; (-huo: lukewarm)
文凭	diploma
文物	cultural relic; historical relic
文献	document; literature
文雅	elegant; refined
文艺	literature and art
问世	be published; to come out
窝	nest; den
乌黑	jet-black; pitch-black
污蔑	to slander
诬陷	entrap; to frame; plant false evidence against sb.
无比	matchless; incomparable
无偿	free; no charge; at no cost
无耻	without any sense of shame; shameless; audaciousness
无动于衷	aloof; indifferent; unconcerned; untouched
无非	nothing but; only
无辜	innocent
无精打采	listless; be dispirited; in low spirits
无赖	hoodlum; rascal; rogue; rascally; scoundrelly
无理取闹	to make trouble without reason (idiom); wilfully make trouble; to be deliberately provocative; deliberately awkward; pointless provocation
无能为力	incapable of action; powerless; impotent
无穷无尽	vast and limitless; endless span of time; no vestige of a beginning, no prospect of an end
无微不至	in every possible way; meticulously
无忧无虑	carefree and without worries
无知	ignorance
武器	weapon; arms
武侠	knight-errant; a genre of swordplay martial arts movies and books
武装	arms; equipment; to arm
侮辱	to insult; humiliate
舞蹈	a dance
务必	must; need to; be sure to
物美价廉	attractive goods at inexpensive prices
物业	property management
物资	goods and materials; commodity
误差	difference; error; inaccuracy
误解	misunderstand; misread
夕阳	setting sun
昔日	formerly; in olden days
牺牲	sacrifice (one's life, etc.)
溪	creek
熄灭	extinguish; go out (of fire); die out; extinction
膝盖	knee
习俗	custom; tradition; (local) convention
袭击	surprise attack; to raid
媳妇	daughter-in-law; son's wife
喜闻乐见	a delight to see (idiom); an attractive spectacle
喜悦	happy; joyous
系列	series
细胞	cell (biology)
细菌	bacteria; virus; germ
细致	delicate; meticulous
峡谷	canyon; ravine; gorge
狭隘	narrow; tight; narrow (minded); lacking in experience
狭窄	narrow
霞	red clouds
下属	subordinate; underling
先进	advanced (technology); to advance
先前	before; previously
纤维	fiber
掀起	lift; raise in height
鲜明	bright; clear-cut; distinct
闲话	gossip; digression
贤惠	virtuous and dutiful (of women)
弦	bow string; string of musical instruments
衔接	to join together; to combine
嫌	to dislike; suspicion; grudge
嫌疑	suspicion; (be) suspected (of)
显著	notable; marked; outstanding; remarkable
现场	scene (of event or incident); on the spot
现成	ready-made; off-the-shelf
现状	current situation; status quo
线索	trail; clues; hints; thread (of a story)
宪法	constitution; charter
陷害	cast blame on; to frame
陷阱	trap; snare
陷入	sink into; get caught up in; land in (a predicament)
馅	stuffing; filling
乡镇	village and town
相差	differ; difference
相等	be equal to; equally; equivalent
相辅相成	supplement and complement each other
相应	correspond; relevant
镶嵌	inlay
响亮	loud and clear; resounding
响应	respond to; answer
想方设法	(saying) think of or try every possible method; by all means possible
向导	guide
向来	always; all along
向往	yearn for; look forward to
巷	lane; alley
相声	comic dialogue; crosstalk
削	to pare/peel with a knife; to cut; to chop
消除	eliminate; remove; clear up (abstract things）
消毒	disinfect; sterilize
消防	fire-fighting; fire prevention and control
消耗	use up; consume
消灭	eliminate; perish; wipe out
销毁	destroy (by melting or burning)
潇洒	free and easy
小心翼翼	carefully; cautiously; with great care
肖像	portrait
效益	benefit；results
协会	an association; a society
协商	consult with; talk things over
协调	coordinate; harmonize
协议	agreement; pact; protocol
协助	assist; to help
携带	take with; portable
泄露	leak (information); divulge
泄气	despair; feel like giving up/disappointing; pathetic
屑	crumbs; filings; worth while
谢绝	politely refuse
心得	knowledge gained
心甘情愿	totally willing; perfectly happy to
心灵	heart; soul; smart; quick-witted
心态	pyschology; mentality; spirit
心疼	love dearly; the pain of love
心血	heart and blood; painstaking effort; meticulous care
心眼儿	one's thoughts; mind; intention; willingness to accept new ideas
辛勤	hardworking; diligent; industrious
欣慰	be gratified; satisfied
欣欣向荣	flourishing; thriving; prosperous
新陈代谢	metabolism (bio); (saying) the new replaces the old
新郎	bridegroom; groom
新娘	bride
新颖	new and original; novel
薪水	salary; wage; pay; stipend
信赖	trust; have confidence in; confide
信念	faith; belief; conviction
信仰	firm belief; faith; believe in (a religion)
信誉	reputation; prestige; trust
兴隆	prosperous; flourishing
兴旺	prosperous; thriving; to prosper
腥	fishy (smell)
刑事	criminal; penal
行政	administration; administrative
形态	shape; form; pattern
兴高采烈	in high spirits
兴致勃勃	in high spirits
性感	sex appeal; sexy; sexuality
性命	life
性能	function; performance
凶恶	fierce; ferocious; menacing
凶手	murderer; assassin; assailant
汹涌	(used in reference to an ocean, river, lake etc.) violently surge up; turbulent
胸怀	think about; heart; one's bosom (the seat of emotions); breast; broad-minded and open
胸膛	chest
雄厚	abundant; strong and solid; rich
雄伟	grand; majestic
修复	restoration; repair
修建	to build; to construct; renovate
修养	accomplishment; self-cultivation
羞耻	(a feeling of) shame
绣	embroider; embroidery
嗅觉	sense of smell; scent
须知	prerequisites; knowledge requirement
虚假	false; phony; pretense; deceit
虚荣	vanity
虚伪	false; hypocritical; artificial; sham
需求	requirement; demand (economics)
许可	allow; permit; permission
序言	preface of a book, used to explain the book's objective
畜牧	raise animals
酗酒	heavy drinking; drink to excess; binge drink
宣誓	swear an oath (of office); make a vow
宣扬	publicize; make public or well known
喧哗	cause a scene
悬挂	suspend; hang; suspension (cable car)
悬念	reader's involvement; suspense in a movie, place etc
悬殊	a wide gap; big contrast; large disparity; a mismatch
悬崖峭壁	cliffside
旋律	melody; tune; rhythm
旋转	to whirl; to spin; rotate
选拔	select the best; choose
选举	elect; election
选手	athlete; contestant; player
炫耀	to show off; flaunt
削弱	weaken; to cripple
学说	theory; doctrine
学位	academic degree; educational level
雪上加霜	(literally) add frost to snow; one disaster after another; insult added to injury
血压	blood pressure
熏陶	to influence (positively)
寻觅	to seek; to look for
巡逻	to patrol (police, army or navy)
循环	circular cycle; loop; circulate
循序渐进	make steady progress incrementally; step by step program
压迫	oppress
压岁钱	gifts of money given to children during the Spring Festival
压缩	to compress
压抑	constrain or repress one's emotions; inhibition; repressive
压榨	to press; to squeeze; to extract juice, oil, etc. by squeezing
压制	suppress; inhibit; stifle
鸦雀无声	not even a crow or sparrow can be heard (idiom); silence reigns
亚军	second place; runner-up
烟花爆竹	fireworks and crackers
淹没	submerge; drown; to flood
延期	delay; extend; postpone
延伸	extend; spread; stretch
延续	continue; last longer
严寒	bitter cold; severe winter
严禁	strictly prohibit; forbid
严峻	grim; severe; rigorous; harsh
严厉	strict; severe
严密	strict; closely-knit; tight
言论	expression of (political) opinion; speech
岩石	rock; stone
炎热	blistering hot; sizzling hot (weather)
沿海	coastal
掩盖	conceal; cover up; hide behind
掩护	cover; shield; screen
掩饰	conceal a fault; gloss over
眼光	vision
眼色	a wink; signal with one's eyes
眼神	expression or emotion showing in one's eyes
演变	develop; evolve
演习	rehearse; practice; put on a play
演绎	deduction; to deduce; to infer
演奏	give an instrumental performance
厌恶	loathe; to hate; detest
验收	inspect and then accept (i.e. received goods
验证	inspect and verify
氧气	oxygen
样品	sample; specimen
谣言	rumor
摇摆	to waver; to wag; to sway
摇滚	rock and roll
遥控	remote control
遥远	distant; remote
要点	main point; essential
要命	cause somebody's death; very; extremely; frighteningly; annoyance
要素	essential factor; key constituent
耀眼	dazzle; to shine
野蛮	barbarous; uncivilized; cruel; wild
野心	ambition; wild schemes or ambitions; careerism
液体	liquid
一度	for a time; at one time; one time; once
一帆风顺	(saying) smooth sailing
一贯	consistent; constant; from start to finish; then as now
一举两得	kill two birds with one stone; (literally) attain two objectives with a single move
一流	top-grade
一目了然	obvious at a glance
一如既往	just as in the past (idiom); as before; continuing as always
一丝不苟	(literally) not one thread loose; strictly according to the rules; meticulous
一向	all along; the whole time; constantly; always
衣裳	clothes
依旧	as before; still
依据	according to; basis; foundation
依靠	rely on; depend on
依赖	depend on; be dependent on
依托	rely on; depend on
仪器	apparatus; (scientific) instrument
仪式	ceremony
遗产	heritage; legacy
遗传	inherit; hereditary
遗留	legacy; left over; hand down
遗失	lose; lose due to carelessness
疑惑	(a sense of) uncertainty; to feel unsure about something; uncertainty
以便	so that; in order to
以免	so as not to; in order to avoid; lest
以往	in the past; formerly
以至	down to; up to; to such an extent as to...
以致	so that; as a result
亦	also
异常	exceptional; abnormal
意料	expectation; to anticipate; to think ahead
意识	realize; consciousness; awareness; sense
意图	intent; intention; intend
意味着	signify; to mean; imply
意向	will; intent; disposition
意志	will; willpower; determination
毅力	willpower; perseverance; will; stamina; tenacity
毅然	without hesitation; resolutely; firmly
翼	wings; fins on fish; shelter
阴谋	a plot; a conspiracy
音响	(Electronic) speakers; acoustics; sound field (i.e., in a room or theater)
引导	to guide; to conduct; introduction
引擎	engine
引用	quote; cite
饮食	food and drink; diet
隐蔽	conceal; hide; covert; under cover; Take cover!
隐患	hidden danger
隐瞒	conceal; hide; (a taboo subject); cover up the truth
隐私	privacy; personal secret
隐约	vague; faint; indistinct
英明	wise; brilliant
英勇	bravery; heroic; valiant; gallant
婴儿	baby infant
迎面	face to face; headlong; in one's face
盈利	profit; gain
应酬	socialize with; a social engagement
应邀	at sb.'s invitation
拥护	to support; endorse
拥有	have; possess
庸俗	filthy; vulgar; debased
永恒	eternal; everlasting
勇于	have the courage to; be brave enough
涌现	spring up; emerge prominently
踊跃	eager; enthusiastically
用户	user; consumer; subscriber; customer
优胜劣汰	survival of the fittest
优先	priority; preferential
优异	exceptional; excellent; outstandingly good
优越	superior; superiority
忧郁	melancholy; dejected
犹如	just as; similar to; appearing to be
油腻	greasy or oily (food)
油漆	oil paint; varnish
有条不紊	in an orderly way; methodically; systematically; methodical
幼稚	childish; naïve; immature
诱惑	tempt; temptation; entice; lure; attract
渔民	fisherman; fisher folk
愚蠢	silly; stupid
愚昧	ignorant; benighted
舆论	public opinion
与日俱增	grow with each passing day
宇宙	universe; cosmos
羽绒服	down jacket
玉	jade
预料	anticipate; to forecast; expectation
预期	expect; expected; anticipate
预算	budget
预先	beforehand; prior
预言	predict; prophecy
预兆	omen, sign
欲望	desire; lust
寓言	fable
愈	recover; heal; the more ... the more
冤枉	to wrong; injustice; not worthwhile
元首	head of state
元素	element; element of a set; chemical element
元宵节	the Lantern Festival
园林	gardens; park; landscape
原告	plaintiff; complainant; accuser
原理	principle; theory
原始	first; original; primitive
原先	former; original
圆满	satisfactory
缘故	reason; cause
源泉	headspring; fountainhead; water source
约束	restrict; limit to; constrain; restriction
乐谱	sheet music
岳母	wife's mother; mother-in-law
孕育	be pregnant; to produce offspring; nurture (a development, school of thought, artwork, etc.)
运算	(mathematical) operation
运行	movement; be in motion; run
酝酿	mull over (an issue); hold a preliminary round of exploratory discussions
蕴藏	hold in store; contain untapped quantities
熨	iron; press
杂技	acrobatics
杂交	create a hybrid; cross-fertilize
砸	to smash; to pound; to break; fail
咋	how/why (contraction of 怎么)
灾难	disaster; catastrophe
栽培	grow; educate; cultivate
宰	slaughter; butcher; govern; rule; imperial official in dynastic China
再接再厉	continue the struggle; persist; unremitting efforts
在意	care about; mind; care
攒	save; hoard
暂且	for the moment; for the time being; temporarily
赞叹	sigh or grasp in admiration; highly praise
赞助	support; sponsor
遭受	suffer; suffering; be subjected to (something unfortunate)
遭殃	to suffer a calamity; go through a disaster
遭遇	befall; suffer; encounter
糟蹋	waste; ruin; wreck; spoil; slander
造型	make a model; to mold
噪音	uproar; rumble; noise; static
责怪	blame; rebuke
贼	thief
增添	add to; increase
赠送	give as a present
扎	to prick; push a needle into; penetrating
扎实	strong; sturdy; practical
渣	dregs; slag
眨	wink; blink
诈骗	defraud; swindle; blackmail
摘要	summary; abstract
债券	bond
沾光	bask in the light; benefit from association with sth.; reflected glory
瞻仰	look at with reverence; admire
斩钉截铁	to chop the nail and slice the iron (idiom); resolute and decisive; definitely
展示	open up; reveal; to display
展望	outlook; prospect; to look ahead; look forward to
展现	come out; emerge; express; show
崭新	brand new
占据	occupy; hold; inhabit
占领	occupy (a territory); capture; seize
战斗	to fight; to battle; to struggle
战略	strategy
战术	(military) tactics
战役	military campaign; battle
章程	written rules; statute; regulations; charter of a corporation
帐篷	tent
障碍	barrier; obstacle
招标	to beckon; to invite bids
招收	recruit; take in; to hire
朝气蓬勃	full of youthful energy (idiom); full of vigour and vitality; energetic; spirited; a bright spark
着迷	to be fascinated
沼泽	marsh; swamp; glade; wetlands
照样	as before; (same) as usual
照耀	to shine; illuminate
折腾	toss from side to side (e.g. sleeplessly); do something over and over again; cause suffering; play crazy; screw around
遮挡	shelter from; keep out
折	to break; to fracture; convert into; to fold
折磨	persecute; to torture
侦探	detective
珍贵	precious
珍稀	rare; precious and uncommon
珍珠	pearl
真理	truth
真相	the actual facts; reality
真挚	sincere; sincerity; genuine
斟酌	Consider; deliberate
枕头	pillow
阵地	position; battlefront
阵容	line-up; troop arrangement
振奋	stir oneself up; raise one's spirits; inspire
振兴	develop vigorously; promote; revive; revitalize; invigorate; re-energize
震撼	to shake
震惊	shock; astonish; amaze
镇定	cool; calm; unperturbed
镇静	calm; cool; tranquil
正月	the first month of the lunar calendar
争端	dispute; controversy; conflict
争夺	fight over
争气	work hard for sth.; determined not to fall short
争先恐后	striving to be first; compete with each other
争议	controversy; dispute; contention
征服	conquer; subdue
征收	levy (fine); impose (tariff)
挣扎	to struggle
蒸发	evaporate; evaporation
整顿	organize; consolidate
正当	timely; just when, (dàng) proper
正负	positive and negative; plus-minus
正规	formal; regular; according to standards
正经	decent; serious; standard; really
正气	healthy environment; healthy atmosphere
正义	justice; righteous
正宗	authentic, orthodox; old school
证实	confirm; verify
证书	certificate; credentials
郑重	serious; solemn
政策	policy
政权	regime; political power; authority
症状	symptom (of an illness)
之际	during; at the time of; the time when something happens
支撑	support; prop up; crutch; brace
支出	spend; pay out; expense
支流	tributary; minor aspect; offshoot
支配	to control
支援	to support; assist; aid
支柱	pillar; prop; mainstay; backbone
枝	branch; twig; (mw for sticks, rods, pencils)
知觉	perception; consciousness; feeling
知足常乐	content with what one has
脂肪	body fat
执行	implementation; carry out; execute
执着	to refuse to change one's viewpoint
直播	live broadcast (not recorded)
直径	diameter
侄子	nephew; brother's son or daughter
值班	be on duty; work a shift
职能	function; role
职位	(professional) position
职务	post; a position; job; duties
殖民地	colony
指标	target; norm; index; indicator
指定	appoint; designate
指甲	fingernail
指令	order; command; instruction
指南针	compass
指示	indicate; instruct; instructions
指望	hope for; count on; hope
指责	to censure; criticize; find fault with
志气	ambition; resolve; backbone; drive; spirit
制裁	punish; (economic) sanctions
制服	uniform; to subdue; to bring under control
制约	restrict; condition
制止	to curb; to put a stop to
治安	law and order; public security
治理	to bring under control; to govern; to manage
致辞	make/deliver a speech
致力	work for; devote one's efforts
致使	cause; result in
智力	intelligence; intellect
智能	intelligent; capability; smart (phone, system, bomb, etc.)
智商	IQ (intelligence quotient)
滞留	detain; retention
中断	interrupt; break off
中立	neutral; neutrality
中央	central; middle; center
忠诚	honest; loyalty; devoted
忠实	faithful; dependable
终点	the end; end point; destination; finish line (in a race)
终究	in the end; after all is said and done; eventually
终身	lifelong
终止	stop; cease; terminate (legal)
衷心	heartfelt; wholehearted; cordial
肿瘤	tumor; neoplasm
种子	seed
种族	race; ethnicity
众所周知	as everyone knows; (saying) as is known to everyone
种植	plant; grow; crop
重心	center of gravity; central core; main part
舟	boat
州	province; sub-prefecture; (United States) state
周边	surrounding
周密	meticulous; careful; thorough
周年	anniversary; annual
周期	period; cycle; rhythm
周折	setback; twists and turns; problem; complication
周转	turnover (in cash or personnel); have enough resources to cover a need
粥	porridge; congee; gruel
昼夜	day and night; continuously without stop
皱纹	wrinkle; furrow
株	stem; root; trunk; (mw for plants)
诸位	(pronoun) everyone; ladies and gentlemen
逐年	year after year; on an annual basis
主办	to host (a conference or sports event)
主导	leading; dominant; guiding
主管	person in charge of (a position, etc.); preside over; Chief Operating Officer (COO)
主流	main stream (of a river); the essential point
主权	sovereignty
主义	-ism; ideology
拄	post; lean on a stick; prop
嘱咐	enjoin; to tell; exhort
助理	assistant
助手	assistant; helper
住宅	residence; tenement
注射	injection; inject (medicine)
注视	watch attentively; gaze at; stare
注释	annotate; annotation; note; make notes in the margin
注重	pay attention; emphasize; put stress on
驻扎	to station; to garrison (troops)
著作	work; book; writing
铸造	cast (pour metal into a mold)
拽	drag; haul
专长	specialty; special knowledge or ability
专程	special-purpose trip
专利	patent
专题	special topic; questions; special matter or subject
砖	brick
转达	pass on; convey; communicate
转让	transfer (technology, good, etc.); make over
转移	to shift; divert; migrate
转折	turning point; shift in the trend of events; plot twist in a book
传记	biography
庄稼	farm crops
庄严	stately; dignified
庄重	grave; solemn; dignified
装备	equipment; to equip; to outfit
装卸	load and unload; to transfer
壮观	spectacular; grand (of buildings, monuments, scenery, etc.)
壮丽	magnificence; splendid; majestic
壮烈	brave and honorable
幢	(mw for houses, buildings); tent
追悼	mourning; memorial (service, etc.)
追究	investigate; look into; find out
坠	fall; drop
准则	principle; standard or norm; criterion
卓越	distinction; excellence; splendid
着手	put one's hand to; commence
着想	give consideration to; consider (other people's) needs
着重	put emphasis on; to stress
琢磨	ponder; (also zhuómó: to polish (gems or literary works))
姿态	attitude; posture; stance
资本	(Economics) capital; asset
资产	property; assets
资深	experienced; senior
资助	subsidy; provide financial aid
滋润	quenched; moist
滋味	taste; flavor; the way one feels
子弹	bullet; cartridge
自卑	feel inferior; be self-abased
自发	spontaneous; unprompted
自力更生	(idiom) self reliance
自满	complacent; self-satisfied
自主	independent; to act for oneself; autonomous
宗教	religion
宗旨	purpose; objective; aim; goal
棕色	brown (the color)
踪迹	tracks; trail; footprint; trace; vestige
总而言之	in short; in a word
总和	sum
纵横	able to move unhindered; length and breadth
走廊	corridor; hallway
走漏	leak (information, liquid, etc); divulge; reveal
走私	smuggle; have an illicit affair
揍	(informal) beat; hit; (regional) smash; break
租赁	rent; lease
足以	sufficient to ...; so much so that; sufficiently
阻碍	obstruct; hinder; impede
阻拦	to stop; obstruct; block off
阻挠	thwart; to obstruct (something); stand in the way
祖父	paternal grandfather
祖国	homeland; motherland; fatherland
祖先	ancestor; forbearer
钻研	study intensively; delve into
钻石	diamond
嘴唇	lip
罪犯	criminal
尊严	dignity; sanctity; honor
遵循	follow; abide by
作弊	practice fraud; cheat
作废	cancellation; delete; to nullify; to expire and thus lose validity
作风	work style; way
作息	work and rest
座右铭	motto
做主	decide; take the responsibility for a decision