哎	hey!; (interjection of surprise or dissatisfaction)
唉	(an exclamation indicating resignation); oh well; oh; mm
爱护	cherish; reassure; take good care of
爱惜	cherish; treasure; use sparingly
爱心	compassion
安慰	to comfort; to console
安装	install; erect; to fix; to mount
岸	bank; shore; beach; coast
暗	dark; gloomy; hidden; secret
熬夜	stay up very late or all night
把握	grasp; hold; certainty; assurance
摆	to put (on); arrange; to sway; pendulum
办理	to handle; to transact; to conduct
傍晚	in the evening; when night falls
包裹	wrap up; bind up; package
包含	contain; embody; include
包括	comprise; include; consist of
薄	thin; flimsy; weak (first two pronunciations)
宝贝	treasure; precious things; darling; baby
宝贵	valuable; precious; value
保持	to keep; maintain; to hold
保存	conserve; preserve; to keep, to save a file in a computer
保留	to reserve; hold back; retain
保险	insurance; insure; safe
报到	report for duty; to check in; register
报道	to report; news report
报告	to report; make known; inform; speech; lecture
报社	newspaper office
抱怨	complain; grumble
背	carry on one's back; to bear
悲观	pessimistic
背景	background
被子	quilt; blanket
本科	undergraduate
本领	skill; ability; capability
本质	essence; nature; innate character
比例	proportion; scale
彼此	each other; one another
必然	inevitable; certain; necessary
必要	necessary; essential; indispensable
毕竟	after all; overall; when all is said and done
避免	avoid; avert; prevent
编辑	to edit; compile; editor
鞭炮	firecracker; a long string of small firecrackers
便	plain; convenient; excretion; formal equivalent to 就; cheap
辩论	argue; debate; argue over
标点	punctuation; punctuation mark; punctuate
标志	sign; mark; signal; symbol
表达	to express; to voice; convey
表面	surface; outside; face
表明	make clear; make known
表情	(facial) expression; express one's feelings
表现	to show; to show off; display; performance
冰激凌	ice cream
病毒	virus
玻璃	glass; nylon; plastic
播放	broadcast; transmit
脖子	neck
博物馆	museum
补充	replenish; to supplement; to complement
不安	uneasy; unstable; disturbed
不得了	extremely; very; terribly; my god! (expression of surprise)
不断	unceasing; uninterrupted; continuously
不见得	not necessarily; not likely
不耐烦	impatience; impatient
不然	otherwise; not so
不如	not as good as; inferior to
不要紧	unimportant; not serious; it doesn't matter
不足	insufficient; not enough
布	cloth; announce; to spread
步骤	step; move; measure; procedure
部门	department; branch; section
财产	property; fortune
采访	interview; gather news; hunt for and collect
采取	carry out or adopt; take(measures, policies, attitudes, etc.)
彩虹	rainbow
踩	step upon; to tread; to stamp
参考	reference; consult
参与	participate (in sth.); attach oneself to
惭愧	ashamed
操场	playground; sports field
操心	worry about
册	book; (mw for books)
测验	test; exam; to test
曾经	once; (refers to something that happened previously)
叉子	fork; cross
差距	disparity; gap; the difference (in distance; amount; progress; etc.)
插	to insert; stick in; pierce
拆	unravel; to tear; demolish
产品	product; goods; merchandise
产生	to produce; emerge; to cause
长途	long distance
常识	common sense; general knowledge
抄	to copy; plagiarize; search and confiscate
超级	super; transcending; high grade
朝	to face; towards; dynasty
潮湿	damp; moist; humid
吵	to quarrel; make noise
吵架	to quarrel; to squabble; bicker
炒	to stir-fry; saute
车库	garage
车厢	carriage; railroad car
彻底	thorough; complete; completely
沉默	silent; uncommunicative
趁	avail oneself of; take advantage of (an opportunity or situation)
称	weigh; to call; be called
称呼	to call; address as; name
称赞	to praise; to acclaim
成分	ingredient; composition
成果	result; achievement; gain
成就	accomplishment; achievement; success
成立	establish; to set up
成人	adult; to grow up; become full-grown
成熟	mature; ripe
成语	idiom; proverb
成长	to mature; grow up
诚恳	honest; sincere
承担	undertake; assume (responsibility)
承认	to admit; concede; acknowledge
承受	to bear; support; endure; sustain
程度	degree; extent; level
程序	procedure; sequence; program
吃亏	suffer losses; get the worst of
池塘	pool; pond
迟早	sooner or later
持续	continue; persist
尺子	ruler (measuring instrument)
翅膀	wing
冲	to rush; to clash; to rinse; thoroughfare
充电器	battery charger
充分	full; abundant; ample
充满	brimming with; very full
重复	to repeat; to duplicate
宠物	a pet
抽屉	drawer
抽象	abstract; abstraction
丑	ugly; disgraceful (2nd Earthly Branch)
臭	stench; stink
出版	publish
出口	exit; speak; export
出色	remarkable; outstanding; excellent
出示	to show
出席	attend; be present; participate
初级	junior; primary
除非	only if; unless
除夕	Lunar New Year's Eve
处理	deal with; to process; sell at a discount; to treat (by a special process)
传播	propagate; to spread
传染	infect; be contagious
传说	it is said; legend; pass on (a story)
传统	tradition; traditional
窗帘	window curtain
闯	rush; break through; to temper oneself (by battling difficulties)
创造	create; bring about; creativity
吹	to blow; to blast; to puff
词汇	vocabulary
辞职	resign from a position
此外	besides; in addition; moreover
次要	secondary; less important
刺激	exciting; provoke; irritate
匆忙	hasty; hurried
从此	from now on; since then
从而	thus; thereby; as a result
从前	previously; formerly; in the past
从事	go for; engage in; deal with
粗糙	coarse
促进	promote (an idea or cause); to advance
促使	to urge; impel; to cause; to push
醋	vinegar
催	to press; to urge; to hurry
存在	to exist; to be
措施	measure; step (to be taken)
答应	to respond; to promise; to answer; agree
达到	achieve; attain; to reach
打工	work a part time job; (regional) do manual labor; do odd jobs
打交道	come into contact with; to deal with
打喷嚏	to sneeze
打听	ask about; inquire about
大方	generous; poise; (-fang1: expert; scholar)
大厦	large building; edifice; mansion
大象	elephant
大型	large-scale; wide-scale
呆	stupid; foolish; blank; dumbstruck; to stay
代表	represent; to delegate
代替	to replace
贷款	(bank) loan; provide a loan
待遇	treatment; pay; wage; salary
担任	hold the post of; serve as
单纯	simple; pure; merely
单调	monotonous; dull
单独	alone
单位	unit; work unit
单元	unit; entrance number; staircase (for residential buildings)
耽误	to delay; waste time
胆小鬼	coward
淡	diluted; weak; thin
当地	local
当心	take care; watch out
挡	to block; hinder; gear; equipment
导演	to direct; director
导致	lead to; bring about; to cause
岛屿	islands
倒霉	have bad luck; be out of luck
到达	to reach; arrive
道德	morals; morality; ethics
道理	reason; sense; argument
登记	register (one's name); check in; enroll
等待	to wait (for); expect
等于	(Mathematics) equal to
滴	to drip; drop; (mw for drops of liquid)
的确	really; indeed
敌人	enemy
地道	authentic; genuine; (-dào: tunnel)
地理	geography
地区	an area; a region; a district
地毯	carpet; rug
地位	position; status
地震	earthquake
递	hand over; to pass; to give
点心	dim sum; light refreshments; snacks
电池	battery
电台	transceiver; broadcasting station
钓	to fish
顶	top; roof; carry on one's head; prop up; to butt; (mw for headwear, i.e. hats)
动画片	animated film
冻	to freeze
洞	cave; hole
豆腐	tofu; bean curd
逗	to tease; amuse; to stay; to stop; funny
独立	independent
独特	unique; distinctive
度过	spend; to pass
断	to break; decide; absolutely (usually negative)
堆	pile; heap; stack; crowd
对比	compare; to contrast; comparison
对待	to treat
对方	counterpart; the other party involved
对手	opponent; adversary; match
对象	target; object; partner; boyfriend or girlfriend
兑换	to exchange; to convert (currencies)
吨	ton
蹲	to crouch; to squat
顿	pause; arrange; stamp feet; suddenly; (mw for meals)
多亏	thanks to; luckily
多余	unnecessary; superfluous
朵	(mw for flowers and clouds)
躲藏	hide oneself; take cover
恶劣	vile; horrible
耳环	earring
发表	publish; to issue (a statement); announce
发愁	worry about sth.
发达	developed (country, etc.); flourishing; prosper
发抖	to shiver; to shudder; tremble
发挥	to bring (skill, talent, etc.) into play; to develop (an idea)
发明	invent
发票	receipt or bill for purchase; invoice
发言	make a speech; statement
罚款	fine; penalty (monetary)
法院	court of law
翻	to turn over; capsize; translate
繁荣	prosperous; prosperity; booming (economy)
反而	on the contrary; instead
反复	repeatedly; over and over
反应	react; respond; reply
反映	reflect; reflection; report on
反正	anyway
范围	scope; range; limits; extent
方	square; direction; side
方案	plan; program (for action, etc.); proposal
方式	way; style; fashion; manner
妨碍	hinder; to hamper; to obstruct
仿佛	to seem as though; as if
非	non-; un-; not be; wrongdoing; simply must
肥皂	soap
废话	nonsense; rubbish
分别	distinguish; split up; difference; to part
分布	be distributed (over an area); be scattered
分配	distribute; assign; allocate
分手	part company; break up
分析	analyze; analysis
纷纷	one after another; in succession; in profusion; diverse; pell-mell
奋斗	strive; to struggle
风格	style
风景	scenery; landscape
风俗	social custom
风险	risk; venture; hazard
疯狂	crazy; madness; wild; extreme popularity; insane; frenzied; unbridled
讽刺	satirize; ridicule; mock; irony
否定	negate; negative
否认	deny; declare to be untrue
扶	to support with hand; to help somebody up
服装	(formal) clothing; costume; dress
幅	width of cloth; size; (mw for pictures, paintings, textiles)
辅导	to coach; to tutor; give advice (in study)
妇女	woman; women in general
复制	duplicate; reproduce
改革	to reform
改进	improve; make better
改善	improve; make better
改正	to correct; amend
盖	lid; top; cover; to build
概括	summarize; generalize
概念	concept; idea
干脆	straightforward; clear-cut; blunt
干燥	to dry (of paint, cement, etc.); dry; dryness
赶紧	at once; hurriedly; lose no time
赶快	at once; immediately
感激	appreciate; feel grateful
感受	feel; experience; emotion; impression
感想	impressions; reflections; thoughts
干活儿	do manual labor; to work
钢铁	steel
高档	top quality; first rate; high class
高级	high-level; high-grade; advanced
搞	do; make; be engaged in
告别	say goodbye to; to leave; to part
格外	especially; additionally
隔壁	next door
个别	individual; specific; isolated; very few
个人	individual; personal; oneself
个性	individuality; personality
各自	each; respective; apiece
根	root; base; (mw for long, slender objects)
根本	root; essence; fundamental; basic; (not) at all; simply
工厂	factory
工程师	engineer
工具	tool; instrument; utensil
工人	worker
工业	industry
公布	make public; announce; publicize
公开	public; make public
公平	fair; impartial; just
公寓	apartment building
公元	(year) AD or CE; Christian era; common era
公主	princess
功能	function; feature
恭喜	congratulate
贡献	contribute; dedicate; contribution
沟通	link; connect; communicate
构成	to constitute; to compose
姑姑	paternal aunt; father's sister
姑娘	young woman; girl
古代	ancient times
古典	classical
股票	shares; stock (market)
骨头	bone; moral character
鼓舞	inspire; heartening
鼓掌	applaud
固定	fixed; regular; stable
挂号	register; check into hospital; send by registered mail
乖	(of a child) obedient; well-behaved; clever; perverse; contrary to reason
拐弯	turn a corner; make a turn
怪不得	no wonder; so that's why
关闭	close; shut
观察	observe; to watch; to survey
观点	point of view; standpoint
观念	notion; thought; concept
官	an official; organ; governmental
管子	tube; pipe; drinking straw
冠军	champion
光滑	glossy; sleek; smooth
光临	(polite) welcome!; honor somebody with one's presence
光明	bright (future); promising; illuminate
光盘	CD (compact disc)
广场	public square; plaza
广大	vast; extensive
广泛	extensive; wide ranging
归纳	conclude from the facts; induce; sum up from the facts
规矩	rule; custom
规律	law (e.g. of science); regular pattern; discipline
规模	scale; scope; extent
规则	rule; law; regulation
柜台	counter; bar; front desk
滚	to roll; get lost; to boil
锅	pot; pan; boiler
国庆节	National Day
国王	king
果然	really; sure enough; as expected
果实	fruit; gains; results
过分	excessive; overly
过敏	be allergic; allergy
过期	overdue; expire
哈	exhale; sip; (sound of laughter)
海关	customs (i.e. border inspection)
海鲜	seafood
喊	call; cry; shout
行业	industry; business
豪华	luxurious
好客	hospitable; to enjoy having guests
好奇	curious
合法	lawful; legitimate; legal
合理	rational; reasonable
合同	contract
合影	joint photo; group photo
合作	cooperate; collaborate; work together
何必	why should; there is no need to
何况	let alone; much less
和平	peace
核心	core; nucleus
恨	to hate
猴子	monkey
后背	back (of the body)
后果	consequences; aftermath
呼吸	breathe
忽然	suddenly; all of a sudden
忽视	neglect; ignore; to overlook
胡说	talk nonsense; drivel
胡同	lane; alley
壶	pot; kettle; jug; (mw for bottled liquids)
蝴蝶	butterfly
糊涂	confused; bewildered; muddled
花生	peanut
划	delimit; to transfer; assign; to row; to paddle; to scratch
华裔	person of Chinese descent
滑	slippery; cunning; crafty
化学	chemistry
话题	subject (of a talk or conversation)
怀念	cherish the memory of; think fondly of
怀孕	become pregnant; have conceived
缓解	to alleviate
幻想	delusion; fantasy; illusion
慌张	flustered; flurried
黄金	gold
灰	ash; gray (grey); dust; lime
灰尘	dust; dirt
灰心	lose heart; be discouraged
挥	to wave; brandish; wield; wipe away
恢复	reinstate; resume; recover
汇率	exchange rate
婚礼	wedding ceremony
婚姻	marriage; matrimony; wedding
活跃	active; vigorous
火柴	match (for lighting fire)
伙伴	partner (for an activity); friend; pal
或许	perhaps; maybe
机器	machine
肌肉	muscle; flesh
基本	basic; fundamental
激烈	intense; acute; sharp; fierce
及格	pass an exam
极其	extremely; exceedingly
急忙	hastily
急诊	emergency call; emergency treatment
集合	gather; assemble; to muster
集体	collective; group
集中	concentrate; to focus; amass
计算	to count; calculate; compute
记录	to record; take notes
记忆	memory; to remember
纪录	a record; to take notes
纪律	discipline; morale; laws and regulations
纪念	commemorate; remember
系领带	tie a neck tie
寂寞	lonely; lonesome
夹子	clip; tongs; folder
家庭	family; household
家务	household duties; chores; housework
家乡	hometown
嘉宾	honored guest
甲	one; armor (1st Heavenly Stem)
假如	if; supposing; in case
假设	suppose that; hypothesis; conjecture
假装	pretend to be; feign
价值	value; worth
驾驶	to drive; to pilot (a ship, an airplane, etc.)
嫁	marry (a husband); take a husband
坚决	resolute; determined; uncompromising
坚强	strong; staunch
肩膀	shoulder
艰巨	very difficult; arduous; hard
艰苦	difficult; hard; arduous
兼职	part time
捡	to pick up; collect; gather
剪刀	scissors
简历	resume; curriculum vitae
简直	simply; at all
建立	establish; to construct; to set up
建设	to build; to construct; construction
建筑	a building; to construct; architecture
健身	work out; body-building
键盘	keyboard
讲究	Be particular about; fastidious; stress; exquisite ; careful study
讲座	a lecture or course of lectures; lecture hall
酱油	soy sauce
交换	to exchange; to swap; to switch
交际	socialize; social intercourse; communication
交往	to associate; to contact
浇	to water; irrigate; to pour; to sprinkle
胶水	(watery) glue; gum
角度	angle; point of view
狡猾	crafty; cunning; sly
教材	teaching materials
教练	(athlete's) coach; sports coach; instructor
教训	lesson; teach someone or learn a lesson; a moral
阶段	stage; phase
结实	sturdy; (also -shí: bear fruit)
接触	come into contact with
接待	receive (a visitor); admit (entry to)
接近	near; be close to
节省	save; use sparingly; frugal
结构	structure; composition
结合	combine; to link; to bind
结论	conclusion; verdict
结账	pay the bill; settle accounts
戒	warn against; swear off
戒指	(finger) ring
届	arrive at; period; session; (mw for events; meetings; etc.)
借口	excuse
金属	metal
尽快	as quickly as possible
尽量	as much as possible; to the best of one's ability (jìn-: eat or drink to one's fill)
紧急	urgent; pressing
谨慎	cautious; prudent
尽力	do one's best; to strive as much as possible
进步	make progress; to advance
进口	import; entrance; enter
近代	modern times; latest generation
经典	classics; scriptures
经商	trade; be in business; do commerce
经营	engage in (a business activity, etc.); run/operate (a business)
精力	energy; vigor
精神	vigor; spirit; mind
酒吧	bar
救	to save (life); to assist; to rescue
救护车	ambulance
舅舅	mother's brother; maternal uncle
居然	unexpectedly; to one's surprise; go so far as to
桔子	tangerine
巨大	immense; enormous; very large
具备	possess; be equipped with
具体	concrete; definite; specific
俱乐部	club (group or organization)
据说	it is said that; reportedly
捐	to contribute; to donate; to subsribe to; to abandon; to relinquish; contribution; tax
决赛	finals (of a competition); final match
决心	determination; resolution
角色	role; part
绝对	absolute; definite
军事	military affairs; military matters
均匀	even; well-distributed
卡车	truck
开发	develop; to exploit (a resource)
开放	(of flowers) to bloom; open up; to be open-minded; lift a ban, restriction, etc.; release; liberalization; China's 1979 open policy
开幕式	opening ceremony
开水	boiled water; boil water
砍	to chop; cut down
看不起	look down upon; despise
看望	visit; call on; see
靠	depend on; lean on; near; to trust
颗	(mw for hearts and small, round things like seeds, grains, beans, etc.)
可见	it can clearly be seen that; clear
可靠	reliable
可怕	terrible; awful; frightful; scary
克	gram; overcome; restrain
克服	overcome (hardships, etc.); conquer
刻苦	hardworking; assiduous
客观	objective; impartial; unbiased
课程	course; curriculum; class
空间	space
空闲	leisure; free time; idle; unused
控制	to control
口味	a person's tastes or preferences
夸	to boast; to praise; exaggerate
夸张	exaggerate; overstate; exaggerated; overstated; vaunted; hyperbole
会计	accountant; accounting
宽	wide; broad; relaxed; lenient
昆虫	insect
扩大	enlarge; expand
辣椒	hot pepper; chili
拦	to block; to cut off; hinder
烂	overcooked; rotten; soft; mushy
朗读	read aloud
劳动	work; toil; (physical) labor
劳驾	excuse me
老百姓	ordinary people; the person on the street; civilians
老板	boss; proprietor; shopkeeper
老婆	(informal) wife
老实	honest; sincere; naive; simpleminded
老鼠	rat; mouse
姥姥	maternal grandmother
乐观	optimism; hopeful
雷	thunder
类型	type
冷淡	cold; chill; indifferent; unconcerned
厘米	centimeter
离婚	to divorce; divorced from (one's spouse)
梨	pear
理论	theory
理由	a reason; grounds; argument
力量	power; force; strength
立即	immediately
立刻	immediately; at once; right away
利润	profit
利息	interest (on a loan)
利益	benefit; (in sb.'s) interest
利用	to use; to make use of; to exploit
连忙	promptly; at once
连续	continually; in a row; successively
联合	alliance; combine; unite
恋爱	romantic love; be in love; love affair
良好	good; favorable; well
粮食	grain; food; cereals
亮	bright; light; shiny
了不起	incredible; extraordinary; great; amazing
列车	train (railway term)
临时	temporary; at the time; when the time comes
灵活	flexible; nimble; agile
铃	bell
零件	spare parts; component
零食	snack
领导	to lead; leader; leadership
领域	domain; sphere; field; area
浏览	browse; glance over; skim through
流传	to spread; circulate; hand down
流泪	shed tears
龙	dragon
漏	to leak; to funnel; to let out
陆地	land; dry land (as opposed to the sea)
陆续	in turn; successively; one after another
录取	recruit; enroll; matriculate
录音	sound recording; to record
轮流	to alternate; take turns; rotate
论文	thesis; paper; treatise
逻辑	logic
落后	backward; to lag (in technology); to fall behind
骂	scold; curse; condemn; verbally abuse
麦克风	microphone
馒头	steamed bun/roll
满足	satisfy; meet (the needs of)
毛病	fault; bad habit; shortcoming
矛盾	contradiction; conflict
冒险	take a risk; take chances
贸易	(commercial) trade
眉毛	eyebrow
媒体	(news) media; medium
煤炭	coal
美术	the fine arts; art
魅力	charm; glamour; enchantment
梦想	dream of; wishful thinking
秘密	a secret; confidential
秘书	secretary
密切	close; familiar; intimate
蜜蜂	bee; honeybee
面对	to face; confront
面积	(surface) area
面临	be faced with; be up against
苗条	slim; slender
描写	to describe; to depict; to portray
敏感	sensitive; susceptible
名牌	famous brand; name brand
名片	business card
名胜古迹	famous scenic spots and ancient historic sites
明确	clear-cut; clearly; clarify
明显	clear; obvious
明星	(movie, etc.) star; celebrity
命令	an order; a command
命运	fate; destiny
摸	to touch; to stroke; fish out; feel out
模仿	imitate; to copy
模糊	vague; indistinct; fuzzy; foggy
模特	(fashion) model
摩托车	motorcycle; motorbike
陌生	strange; unfamiliar
某	a certain; some
木头	wood; log; timber
目标	target; goal; objective
目录	catalog; table of contents; directory (on computer hard drive)
目前	at present; now; for the moment
哪怕	even (if/though); no matter how
难怪	no wonder
难免	hard to avoid; difficult to escape from
脑袋	head; mental capability; brains
内部	internal; interior; inside (part, section)
内科	internal medicine
嫩	tender; inexperienced
能干	capable; competent
能源	energy resources; power source
嗯	(interjection expressing what?, huh? hmm? why? ok, etc.)
年代	decade; era
年纪	age
念	read aloud; to study; to miss or think of somebody
宁可	would rather; it is the lesser of two evils to
牛仔裤	jeans; cowboy pants
农村	rural area; countryside
农民	peasant
农业	agriculture; farming
浓	concentrated; dense
女士	lady; madam
欧洲	Europe
偶然	accidentally; occasional; fortuitous
拍	to clap; to pat; to shoot (pictures, a film); send (a telegram)
派	dispatch; (mw for political groups; schools of thought; etc.)
盼望	to hope for; look forward to
培训	cultivate; train
培养	to train; cultivate; bring up
赔偿	compensate; pay for somebody else's loss
佩服	admire; to respect
配合	be harmoniously combined or arranged; matching; fitting in with; compatible with; to correspond; to fit; to conform to; rapport; to coordinate with; to act in concern with; to cooperate; to become man and wife; to combine parts of a machine
盆	basin; (flower) pot
碰	to touch; to bump; to encounter
批	criticize; to comment; wholesale; (mw for batches, lots, etc.)
批准	approve; ratify
披	drape over one's shoulders; split open; open
疲劳	fatigue; wearily; weariness; tired
匹	ordinary person; (mw for horses, bolt of cloth)
片	(mw for pieces of things); a slice; a flake; film; photo
片面	one-sided; unilateral
飘	to float; flutter
拼音	pinyin; phonetic writing
频道	frequency; (television) channel
平	flat; level; equal; ordinary
平安	safe and sound
平常	ordinary; usually; common
平等	equal; equality
平方	square (as in square foot, square mile, etc.)
平衡	balance; balanced; equilibrium
平静	calm; peaceful; tranquil; serene
平均	average; to share equally
评价	to evaluate
凭	lean against; evidence; proof; no matter (what/how/etc.)
迫切	urgent; pressing
破产	go bankrupt; go broke; bankruptcy
破坏	destroy; destruction; to wreck; to break
期待	look forward to; await; expectation
期间	period of time; time
其余	the others; the rest; remaining
奇迹	miracle; miraculous; marvel
企业	company; business; firm
启发	enlighten; inspire
气氛	atmosphere; mood; ambience
汽油	gasoline; gas; petrol
谦虚	modest
签	bamboo used for drawing lots; toothpick; to sign (one's name)
前途	future; prospects; outlook (for the future)
浅	shallow; simple; superficial; light (of colors)
欠	yawn; to lack; owe
枪	gun; spear
强调	emphasize; to stress
强烈	intense; strong; violent
墙	wall
抢	fight over; vie for; grab; rush; bump against
悄悄	quietly
瞧	look at; see (colloquial)
巧妙	ingenious; clever
切	to cut; to chop; correspond to; absolutely; ardently
亲爱	beloved; Dear ... (a way of starting a letter lovers, intimate friends or close relatives)
亲切	kind; amiable; cordial
亲自	personally
勤奋	hardworking; diligent; industrious
青	blue; green; young
青春	youth; youthfulness; fresh spring
青少年	teenager
轻视	contempt; to scorn; scornful
轻易	easily; lightly; rashly
清淡	light (of food, not greasy or strongly flavored) ; insipid;  slack (sales)
情景	scene; sight; circumstances
情绪	emotion; sentiment; mood; morale
请求	to request; ask
庆祝	celebrate
球迷	fan (of ball games: basketball, football, etc.)
趋势	trend; tendency
取消	cancel; cancellation; abolish
娶	marry (a wife); take a wife
去世	pass away; die
圈	circle; ring; (mw for loops, orbits, etc.)
权力	power; authority
权利	right; privilege
全面	all-around; comprehensive; fully
劝	advise; to urge; persuade
缺乏	shortage; to lack; be short of
确定	definite; certain; fixed; determine
确认	confirm; confirmation; verify
群	crowd; group; (mw for groups, flocks, or swarms)
燃烧	combustion; burn; kindle
绕	to wind; to coil; move round
热爱	love ardently; adore; passion
热烈	warm; enthusiastic
热心	enthusiastic; zealous; warmhearted
人才	talent; talented person
人口	population; the populace
人类	humanity; human race; mankind
人民币	(currency) renminbi (RMB)
人生	human life
人事	personnel
人物	figure; personage; character (in a play, story, etc.)
人员	staff; crew; personnel
忍不住	cannot help but; unable to bear
日常	daily; everyday
日程	schedule; itinerary
日历	calendar
日期	date
日用品	daily necessities
日子	days; date; time; life
如何	how; what; what way
如今	nowadays
软	soft
软件	(computer) software
弱	weak; feeble; young
洒	to sprinkle; to spray; to spill
嗓子	throat; voice
色彩	tint; color; hue
杀	to kill; to murder
沙漠	desert
沙滩	sand bar; sand beach
傻	foolish; fool
晒	to dry in the sun; shine upon; to sun; bask
删除	to delete
闪电	lightning
扇子	fan (for waving)
善良	good and honest; kind-hearted
善于	be good at; excel at
伤害	injure; to harm; wound
商品	goods; commodity; merchandise
商务	business; commercial affairs
商业	business; commerce; trade
上当	be fooled; be duped; be taken in
蛇	snake; serpent
舍不得	hate to part with; begrudge doing something
设备	equipment; facilities; installations
设计	plan; design
设施	facilities; installation
射击	to shoot; to fire (a gun)
摄影	take a photograph; shoot a film
伸	to stretch; extend
身材	stature; figure; build
身份	identity; status; dignity
深刻	profound; deep
神话	mythology; fairy tale
神秘	mysterious; mystical
升	rise; hoist; promote; liter
生产	to produce; manufacture; give birth to a child
生动	vivid; lively
生长	grow; grow up
声调	tone; note
绳子	cord; string; rope
省略	to omit; to leave out; abbreviate
胜利	victory; triumph
失眠	lose sleep; insomnia
失去	to lose (time, an opportunity, work, etc.)
失业	lose one's job; unemployment
诗	poem; poetry; verse
狮子	lion
湿润	moist; humid
石头	stone; rock
时差	jetlag; time difference
时代	age; era; period
时刻	moment; constantly
时髦	fashionable
时期	period in time or history; period; time
时尚	fashion; fad
实话	truth
实践	practice; put into practice; carry out
实习	to practice; field work; work as an intern
实现	achieve; to implement
实验	experiment; test
实用	practical; pragmatic; functional
食物	food
使劲	exert all one's strength
始终	from beginning to end; all along
士兵	soldier
市场	market
似的	seems as if; rather like
事实	fact; in fact
事物	thing; object
事先	in advance; beforehand; prior
试卷	exam paper; test paper
收获	harvest; acquisition; gain
收据	receipt
手工	hand-made; handicraft; manual
手术	surgery; operation
手套	glove; mitten
手续	formalities; procedure
手指	finger
首	head; chief; first; (mw for poems and songs)
寿命	life span; life expectancy
受伤	sustain injuries (in an accident, etc.); be injured
书架	bookshelf
梳子	comb; hairbrush
舒适	cozy; comfortable; snug
输入	input; enter; import
蔬菜	vegetables; produce
熟练	practiced; proficient; skilled
属于	belong to; be part of
鼠标	mouse (computer)
数	number; to count; to rank
数据	data; numbers; digital
数码	numeral; number; amount; digital
摔倒	fall down; slip and fall; tumble; trip
甩	to throw; to fling; to swing; cast off
双方	bilateral; both sides; both parties involved
税	tax
说不定	can't say for sure; perhaps; maybe
说服	persuade; convince
丝绸	silk
丝毫	the slightest amount or degree; a very little bit
私人	private (citizen); personal; individual
思考	reflect on; ponder; consider
思想	thought; thinking; idea; ideology
撕	to tear (something)
似乎	it seems; as if; seemingly
搜索	search; look for something; scour
宿舍	dormitory; living quarters; hostel
随身	carry on one's person; bring with one
随时	at any time; whenever necessary
随手	convenient; without extra trouble
碎	broken; break into pieces
损失	loss (financial); lose
缩短	shorten; cut down; curtail
所	place; that which; (mw for houses, buildings)
锁	lock
台阶	flight of steps; sidestep; fig. way out of an embarrassing situation
太极拳	Tai chi, a Chinese martial art
太太	wife; married woman; Madame; Mrs.
谈判	negotiate; negotiation; conference
坦率	frank
烫	to scald; to burn; scalding hot; to iron
逃	to escape; run away; flee
逃避	to escape; evade; shirk
桃	peach
淘气	naughty; bad
讨价还价	bargaining; haggling over price
套	cover; (mw for sets of things); tie together
特色	characteristic; distinguishing feature
特殊	special; particular; extraordinary; unusual
特征	characteristics; distinctive features; trait
疼爱	love dearly; be very fond of
提倡	promote; to advocate; proposal
提纲	outline; the key point
提问	put questions to; to quiz
题目	subject; title; topic
体会	know from experience; learn through experience; realize; understanding; experience
体贴	show consideration for; thoughtful
体现	embody; incarnate; reflect; to manifest
体验	experience for oneself; to personally experience (usually a kind of life)
天空	sky; space; heavens
天真	naïve; innocent; artless
调皮	naughty; mischievous; unruly
调整	adjustment; revision
挑战	challenge
通常	regular; usual; normal; ordinary
统一	unify; unite; integrate; universal
痛苦	pain; suffering; agony
痛快	joyful; delighted; very happy; jolly
偷	steal; pilfer
投入	put into operation; throw into; to invest
投资	investment
透明	transparent; open (non-secretive)
突出	prominent; stand out; give prominence to
土地	land; territory; soil
土豆	potato
吐	to spit; to vomit; throw up
兔子	rabbit; hare
团	round; ball; group; unite; dumpling; (mw for ball-like things)
推辞	to decline; turn down
推广	popularize; to spread
推荐	recommend; recommendation
退	to retreat; decline; withdraw
退步	to degenerate; to regress
退休	retirement (from work); retire
歪	askew; crooked; devious; recline to take a rest (colloquial)
外公	maternal grandfather
外交	diplomacy; foreign affairs
完美	perfect
完善	perfect; make perfect; improve
完整	complete; intact
玩具	plaything; toy
万一	just in case; if by any chance
王子	prince; son of a king
网络	network
往返	go back and forth; go to and fro
危害	endanger; jeopardize; to harm
威胁	threaten; to menace
微笑	smile
违反	violate (a law)
围巾	scarf; shawl
围绕	revolve around; center on (an issue)
唯一	only; sole
维修	maintain (of equipment); to mend; repair
伟大	great; mighty; large
尾巴	tail
委屈	feel wronged; nurse a grievance
未必	not necessarily; need not
未来	future
位于	be located at
位置	position; place; seat
胃	stomach
胃口	appetite
温暖	warm
温柔	gentle and soft; tender; gentle
文件	document; file
文具	stationery; writing supplies
文明	civilization; civilized; culture
文学	literature
文字	characters; script; writing
闻	hear; to smell; news; reputation
吻	kiss; lips
稳定	stable; steady
问候	send a greeting; send one's regards to
卧室	bedroom
握手	to shake hands
屋子	room; house
无奈	can't help but; have no choice
无数	countless; innumerable
无所谓	doesn't matter; be indifferent
武术	martial arts
勿	not; do not
物理	physics; physical
物质	matter; substance; material
雾	fog; mist
吸取	absorb; assimilate
吸收	absorb; ingest
戏剧	drama; play; theater
系	be; relate to; system; fasten; department; faculty; connect; to tie
系统	system
细节	details; particulars
瞎	blind
下载	to download
吓	frighten; to scare; intimidate
夏令营	summer camp
鲜艳	bright-colored
显得	appear; seem; to look
显然	clear; evidently; obviously
显示	display, illustrate, to show
县	county; district
现代	modern times; modern age
现实	reality; actuality; practical
现象	appearance; phenomenon
限制	restrictions; to limit; to bound
相处	get along; interact
相当	equivalent to; appropriate; considerably; quite
相对	opposite; relatively; to resist
相关	correlation; interrelated; dependence
相似	similar; resemble; like
香肠	sausage
享受	enjoy
想念	to miss; remember with longing; long to see again
想象	imagine; visualize
项	nape (of the neck); sum (of money); mw item
项链	necklace
项目	program; item; project
象棋	chess; Chinese chess
象征	symbol; symbolize; signify
消费	consumption; spending
消化	to digest
消极	passive; negative; demoralized
消失	disappear; fade away; dissolve
销售	to sell; to market; sales
小麦	wheat
小气	stingy; petty
孝顺	filial piety
效率	efficiency
歇	to rest; to go to bed; to take a break
斜	slanting; tilted
写作	writing; composition; written works
血	blood
心理	psychology; psychological; mental
心脏	heart
欣赏	appreciate; enjoy; admire
信号	signal
信任	to trust; have confidence in
行动	to move; get around; action
行人	pedestrian
行为	action; behavior; conduct
形成	take shape; form
形容	describe; appearance; look
形式	form; shape; situation
形势	circumstances; situation; terrain
形象	image; form; figure
形状	form; figure; shape
幸亏	fortunately; luckily
幸运	luck; fortune
性质	nature; characteristic; quality
兄弟	brothers; younger brother; brethren
胸	chest; bosom; heart
休闲	recreation; leisure
修改	amend; modify; revise; alter
虚心	modest; open-minded
叙述	retell; narrate
宣布	announce; declare; proclaim
宣传	propaganda; to propagate; to give publicity to
学历	educational background; school record
学术	learning; science; academic
学问	learning; knowledge
寻找	seek; look for; quest
询问	inquire about
训练	to train; to drill; to exercise; training
迅速	fast; quick; rapid
押金	security deposit; down payment
牙齿	tooth
延长	extend; prolong; lengthen
严肃	solemn; serious; earnest
演讲	give a lecture; make a speech
宴会	banquet; feast; dinner party
阳台	balcony
痒	to itch; itchy
样式	type; style; form
腰	waist; lower back; pocket
摇	to shake; to rock
咬	to bite; to nip
要不	otherwise; or else; how about
业务	business; profession
业余	spare time; amateur
夜	night; darkness
一辈子	(for) a lifetime; all one's life
一旦	in case (something happens); once (sth. has happened ... then); in one day
一律	same; uniformly; all; without exception
一再	repeatedly; again and again
一致	unanimous; identical (views or opinions); consistent
依然	still; as before
移动	to move
移民	immigrate; emigrate; migrate
遗憾	regret; pity; sorry
疑问	doubt; question; to query
乙	two; twist (2nd Heavenly Stem)
以及	as well as; too; (formal) and
以来	since (a previous event)
亿	one hundred million (100,000,000)
义务	duty; obligation; volunteer duty
议论	discuss; to comment; talk about
意外	unexpected; accident; mishap
意义	meaning; significance
因而	therefore; as a result; thus
因素	element; factor
银	silver (the element)
印刷	print
英俊	handsome
英雄	hero
迎接	meet; greet; to welcome
营养	nutrition; nourishment; sustenance
营业	do business; to trade
影子	shadow; reflection
应付	to cope with; deal with; handle; do sth. perfunctorily; do sth. after a fashion; make do
应用	to apply; to use; application
硬	hard; stiff; obstinately
硬件	hardware
拥抱	embrace; to hug
拥挤	to crowd; to push; to squeeze
勇气	courage; valor
用功	diligent; industrious; hardworking
用途	use; application; purpose
优惠	preferential; favorable
优美	graceful; fine; elegant
优势	advantage; superiority; dominant position
悠久	established; long; longstanding
犹豫	hesitate; hesitant; undecided
油炸	deep fry
游览	go sight-seeing; tour
有利	advantageous; beneficial
幼儿园	kindergarten; nursery school
娱乐	entertain; amuse; entertainment
与其	rather than; better than
语气	tone; manner of speaking; mood
玉米	corn; maize
预报	to predict; forecast
预订	place an order; book ahead; subscribe for
预防	prevent; take precautions against
元旦	New Year's Day
员工	employee; staff; personnel
原料	raw material; ingredients
原则	principle; doctrine
圆	round; circular; formal unit of Chinese currency
愿望	desire; wish; aspiration
乐器	musical instrument
晕	dizzy; to fain
运气	luck
运输	transport; transportation
运用	to use; apply
灾害	disaster; calamity
再三	over and over again; repeatedly
在乎	care about; be determined by; to mind
在于	lie in; be in; rest with; depend on
赞成	approve; endorse
赞美	admire; applause; to praise
糟糕	terrible; too bad; how terrible; what bad luck; what a mess
造成	to cause; make; bring out
则	standard; regulation; however; in that case
责备	to blame; criticize (sb.); accuse
摘	to pick (flowers, fruit, etc.); to pluck; to take; to borrow
窄	narrow; petty; hard-up
粘贴	to paste
展开	spread out; unfold; carry out; in full swing
展览	put on display; to exhibit; exhibition
占	occupy; seize; to constitute
战争	war; conflict
长辈	an elder; an elder generation
涨	to rise (of prices, rivers); to go up; to swell; to bloat
掌握	to grasp; to master; to control
账户	bank account
招待	receive (guests); entertain; reception
着火	catch fire; ignite
着凉	catch a cold
召开	convene (a conference or meeting); call together
照常	as usual; normal
哲学	philosophy
针对	in connection with; directed towards
珍惜	to treasure; cherish; to value
真实	true; real; authentic
诊断	diagnosis; diagnose
阵	short period; disposition of troops; wave
振动	vibrate; vibration
争论	argue; to dispute; contend; argument
争取	fight for; compete for; strive
征求	solicit; seek; ask for; to request
睁	to open (eyes)
整个	whole; entire; total
整齐	tidy; neat; in good order
整体	whole; entirety
正	straight; currently; correct; just (right); pure; precisely
证件	paperwork; credentials; papers; certificates
证据	evidence; proof; testimony
政府	government
政治	politics
挣	to earn; to struggle
支	branch; support; put up; (mw for long; narrow objects)
支票	(bank) check
执照	a license; a permit
直	straight; vertical; frank; directly; continuously
指导	to guide; give directions
指挥	to command; to conduct; commander
至今	up to now; so far
至于	as for; go so far as to
志愿者	volunteer
制定	formulate; lay down (a plan or policy); to draft
制度	system; institution
制造	manufacture; make
制作	make; manufacture
治疗	to treat; to cure; medical treatment
秩序	order; sequence
智慧	wisdom; knowledge
中介	agent; act as an intermediary
中心	center; heart; core
中旬	middle third of a month
种类	kind; category; class
重大	great; important; major
重量	weight
周到	thoughtful; considerate; thorough
猪	pig
竹子	bamboo
逐步	step by step; gradually
逐渐	gradually; by degrees
主持	preside over; manage; to direct
主动	to take initiative; voluntary
主观	subjective
主人	master; host; owner
主任	director; head; chief
主题	theme; subject; topic
主席	chairperson; president
主张	to advocate; viewpoint; position
煮	to boil; to cook
注册	register; registration; enroll
祝福	blessings; wish well
抓	to carry in your hand holding strongly; catch; arrest
抓紧	to grasp firmly; to pay close or special attention to; to rush in; to make the most of
专家	expert; specialist
专心	be absorbed; concentrate; attentive
转变	to change; to transform
转告	pass on; to communicate; to transmit
装	to load; dress up; pretend; clothing; to install
装饰	decorate
装修	renovate; to fit up
状况	condition; state; situation
状态	state of affairs; condition; state
撞	to hit; collide; run into
追	pursue; chase
追求	pursue; seek
咨询	request information; consultant; advisory
姿势	posture; position; pose
资格	qualifications; seniority
资金	funds; funding
资料	data; material; resources; information
资源	natural resource; resource
紫	purple
自从	since; ever since
自动	automatic
自豪	(feel a sense of) pride
自觉	conscious; be aware of; self-motivated
自私	selfish
自由	freedom; free; liberty
自愿	voluntary
字母	letter (of the alphabet)
字幕	subtitles; captions
综合	synthesized; composite; summarize
总裁	director-general; president
总共	altogether; in sum; in all; in total
总理	premier; prime minister
总算	at long last; finally; on the whole
总统	president (of a country)
总之	in a word; in short; in brief / anyway; anyhow
阻止	prevent; to block
组	compose; team up; group
组成	to form; part; element; constitute
组合	assemble; combination
组织	organize; organization
最初	first; primary; initial
醉	intoxicated; become drunk
尊敬	respect; revere
遵守	observe; abide by; comply with; keep (commandments); to respect (an agreement)
作品	works (of literature and art)
作为	regard as; act as; action; deed
作文	write an essay; essay